Player,AHL.Season,AHL.GP,AHL.Goals,AHL.Assists,AHL.Fights,AHL.Points,NHL.Season,NHL.GP,NHL.Goals,NHL.Assists,NHL.Fights,NHL.Points,WHL.Seasons,WHL.GP,WHL.Goals,WHL.Assists,WHL.Fights,WHL.Points
Trent Whitfield,15,808,256,344,4,600,8,194,11,18,6,29,1,65,38,44,1,82
Josh Green,10,368,102,146,7,248,9,341,36,40,8,76,1,31,35,19,2,54
Arron Asham,6,139,40,49,16,89,15,789,94,114,102,208,1,67,43,49,13,92
Boyd Kane,15,952,221,302,23,523,5,31,0,3,3,3,1,68,48,45,5,93
Mark Parrish,6,169,52,71,0,123,12,722,216,171,4,387,1,54,54,38,1,92
Matt Pettinger,6,267,67,62,14,129,9,422,65,58,10,123,1,27,14,6,3,20
Cory Sarich,3,94,3,32,4,35,15,969,21,137,45,158,1,46,8,40,5,48
Joel Kwiatkowski,6,276,45,93,0,138,7,282,16,29,0,45,1,62,21,43,1,64
Michal Rozsival,3,79,11,30,2,41,14,890,66,227,3,293,1,71,14,55,2,69
Shane Willis,8,317,115,136,1,251,5,174,31,43,0,74,1,64,58,54,0,112
Ryan Johnson,3,102,27,67,0,94,13,701,38,84,2,122,1,2,0,0,0,0
Josh Holden,6,333,119,155,13,274,6,60,5,9,0,14,1,56,41,58,4,99
David Koci,7,207,2,13,78,15,5,142,3,1,43,4,1,70,2,7,7,9
Chuck Kobasew,3,108,53,26,4,79,11,601,110,100,15,210,1,55,41,21,2,62
Joey Tetarenko,8,415,24,64,113,88,4,73,4,1,19,5,1,49,2,12,14,14
Jannik Hansen,4,129,34,46,1,80,8,470,77,107,5,184,1,64,24,40,5,64
Rick Berry,7,383,25,74,36,99,4,197,2,13,22,15,1,59,9,21,6,30
Mark Smith,4,165,41,73,11,114,7,377,23,47,33,70,1,70,42,67,13,109
Bryce Lampman,9,365,26,72,0,98,3,10,0,0,0,0,1,29,1,17,0,18
Kirby Law,8,540,198,232,37,430,3,9,0,1,0,1,1,49,34,44,10,78
Martin Sonnenberg,8,476,126,150,7,276,3,63,2,3,1,5,1,72,40,52,2,92
Sergei Varlamov,6,398,122,178,1,300,4,63,8,7,0,15,1,72,66,53,2,119
Ronald Petrovicky,4,155,35,54,16,89,6,342,41,51,27,92,1,71,64,49,17,113
Jay Henderson,7,387,86,102,71,188,3,33,1,3,3,4,1,72,49,45,10,94
Zenith Komarniski,7,415,56,104,21,160,3,21,1,1,0,2,1,46,7,24,5,31
Jesse Wallin,5,233,10,42,3,52,4,49,0,2,3,2,1,14,1,6,1,7
Lance Ward,5,243,12,44,22,56,4,209,4,12,29,16,1,71,8,25,12,33
Alex Edler,2,51,5,22,0,27,9,568,66,193,0,259,1,62,13,40,0,53
Roman Polak,2,87,4,15,2,19,9,480,18,70,13,88,1,65,5,18,1,23
Alexander Urbom,4,225,5,49,5,54,4,34,3,1,2,4,1,66,12,21,1,33
Ryan Carter,2,89,19,22,7,41,8,413,34,47,30,81,1,15,0,1,1,1
Scott Parker,2,100,16,10,37,26,8,308,7,14,75,21,1,71,30,22,16,52
Eric Brewer,1,25,2,2,2,4,16,1009,77,194,21,271,1,34,5,28,3,33
Johnathan Aitken,7,410,8,42,44,50,2,44,0,1,8,1,1,69,9,25,11,34
Mikael Backlund,2,55,15,17,0,32,7,298,51,77,2,128,1,28,12,18,0,30
T.J. Galiardi,2,67,10,18,0,28,7,321,44,61,2,105,1,72,18,52,3,70
Matt Ellison,4,256,64,93,8,157,3,43,3,11,1,14,1,72,40,56,0,96
Petr Kalus,5,213,40,40,23,80,2,11,4,1,0,5,1,60,36,22,4,58
Duncan Keith,1,75,7,18,0,25,10,766,75,340,6,415,1,37,11,35,2,46
Radko Gudas,3,206,15,42,42,57,3,126,7,25,10,32,1,65,7,30,9,37
Andrej Podkonicky,4,251,55,76,5,131,2,8,1,0,0,1,1,64,30,44,3,74
Kevin Connauton,4,221,33,55,10,88,2,98,10,19,1,29,1,69,24,48,7,72
Konstantin Pushkarev,4,234,47,72,3,119,2,17,2,3,0,5,1,69,22,30,2,52
Mikhail Yakubov,4,182,22,31,0,53,2,53,2,10,0,12,1,71,32,57,0,89
Tyler Pitlick,4,159,21,43,1,64,2,27,3,0,0,3,1,56,27,35,0,62
Ben Clymer,1,50,11,16,4,27,7,438,52,77,25,129,1,70,12,44,5,56
Jakub Klepis,3,104,22,52,2,74,2,66,4,10,0,14,1,70,14,50,0,64
Dmitri Yakushin,5,238,7,23,11,30,1,2,0,0,0,0,1,42,1,24,4,25
Barrett Heisten,4,250,38,43,11,81,1,10,0,0,0,0,1,58,20,57,3,77
Garret Stroshein,4,140,2,7,47,9,1,3,0,0,2,0,1,11,0,0,5,0
Greg Kuznik,4,207,8,14,11,22,1,1,0,0,0,0,1,72,5,12,14,17
Michal Sivek,4,127,28,49,2,77,1,38,3,3,0,6,1,53,23,37,1,60
Marian Cisar,1,2,1,0,0,1,3,73,13,17,0,30,1,52,33,40,2,73
Victor Rask,2,86,17,27,0,44,1,80,11,22,0,33,1,64,33,30,0,63
Greg Leeb,1,79,14,17,0,31,1,2,0,0,0,0,1,68,46,50,1,96
Henrik Samuelsson,1,68,18,22,0,40,1,3,0,0,0,0,1,28,7,16,1,23
Tomas Kopecky,6,268,73,89,4,162,10,578,68,106,3,174,2,109,56,70,2,126
Andrew Ference,4,89,14,38,4,52,15,901,43,182,31,225,2,112,22,78,5,100
Jason Chimera,4,237,70,89,11,159,14,869,143,186,33,329,2,130,66,66,6,132
Darcy Hordichuk,4,100,7,11,19,18,12,542,20,21,137,41,2,129,9,10,65,19
Brett McLean,7,351,95,140,0,235,6,385,56,106,2,162,2,119,89,100,1,189
Tyler Sloan,12,435,15,50,16,65,3,99,4,13,1,17,2,140,8,57,9,65
Ryan Hamilton,9,494,154,132,20,286,4,30,1,4,0,5,2,15,0,1,0,1
Todd Fedoruk,4,42,1,6,16,7,9,545,32,65,103,97,2,119,25,24,35,49
Colin McDonald,7,449,110,127,17,237,5,140,18,26,3,44,2,3,0,0,0,0
Scott Hannan,2,43,5,12,2,17,16,1055,38,179,9,217,2,94,25,60,2,85
Brad Ference,5,277,14,69,30,83,6,250,4,30,35,34,2,105,18,66,20,84
Ryan Shannon,5,186,41,109,2,150,6,305,35,64,0,99,2,138,5,30,21,35
Tomas Fleischmann,3,104,52,63,0,115,10,581,123,187,1,310,2,125,54,92,0,146
Martin Erat,2,90,20,44,0,64,13,881,176,369,0,545,2,114,50,85,1,135
Nick Holden,6,295,26,92,3,118,4,139,15,24,0,39,2,137,30,61,1,91
Steve Gainey,6,355,60,90,32,150,4,33,0,2,2,2,2,136,51,68,12,119
Brad Leeb,7,469,173,140,7,313,3,5,0,0,0,0,2,127,55,70,10,125
Robert Schnabel,7,341,13,36,46,49,3,22,0,3,2,3,2,62,1,22,9,23
Fredrik Sjostrom,3,21,2,7,0,9,7,489,46,58,1,104,2,121,53,74,0,127
Josef Melichar,3,152,6,18,9,24,7,349,7,42,6,49,2,132,17,52,6,69
Oleg Saprykin,3,94,29,37,2,66,7,325,55,82,2,137,2,114,77,82,3,159
Kyle Calder,2,77,26,31,1,57,10,590,114,180,4,294,2,123,69,96,2,165
Cam Severson,6,338,62,51,49,113,3,37,3,0,5,3,2,110,48,53,21,101
Jim O'Brien,6,266,60,86,5,146,3,63,8,4,0,12,2,133,48,69,1,117
Milan Bartovic,6,323,80,56,2,136,3,50,3,14,1,17,2,90,41,56,2,97
Mike Siklenka,8,229,20,33,32,53,2,2,0,0,0,0,2,69,19,13,5,32
Jaroslav Svoboda,4,93,16,20,1,36,4,134,12,17,0,29,2,110,49,76,1,125
Milan Kraft,4,128,51,75,3,126,4,207,41,41,0,82,2,124,74,81,0,155
Robyn Regehr,1,5,0,0,0,0,15,1089,36,163,40,199,2,119,16,30,10,46
Marek Svatos,2,60,18,8,0,26,7,344,100,72,1,172,2,92,61,57,0,118
Burke Henry,6,375,24,111,31,135,2,39,2,6,3,8,2,140,36,123,20,159
Craig Weller,6,300,32,51,31,83,2,95,4,10,12,14,2,99,6,18,15,24
Martin Cibak,4,177,15,39,0,54,3,154,5,18,0,23,2,124,37,55,0,92
Tomas Plihal,4,193,25,47,1,72,3,89,7,9,0,16,2,139,67,96,1,163
Sven Baertschi,3,124,38,57,0,95,4,69,10,20,0,30,2,113,67,112,0,179
Mitch Fritz,11,322,11,21,85,32,1,20,0,0,6,0,2,110,13,2,51,15
Martin Marincin,5,128,10,35,0,45,2,85,1,10,0,11,2,125,25,71,1,96
Tomas Kundratek,5,247,36,60,3,96,2,30,1,6,0,7,2,116,6,52,5,58
Ole-Kristian Tollefsen,2,74,3,16,11,19,5,163,4,8,23,12,2,96,9,41,7,50
Oscar Moller,3,110,40,48,0,88,3,87,12,14,0,26,2,131,71,81,0,152
Roman Horak,3,139,41,48,0,89,3,84,6,13,0,19,2,130,47,78,1,125
Jeremy Yablonski,8,280,7,15,97,22,1,1,0,0,1,0,2,74,4,1,28,5
Vladimir Mihalik,4,270,6,52,21,58,2,15,0,3,0,3,2,115,10,28,9,38
Nino Niederreiter,2,80,31,23,0,54,4,225,40,36,0,76,2,120,77,53,2,130
Jame Pollock,7,330,69,128,2,197,1,9,0,0,0,0,2,125,21,68,0,89
Riley Armstrong,7,334,78,70,4,148,1,2,0,0,0,0,2,134,24,36,2,60
Josh Olson,6,241,41,35,6,76,1,5,1,0,0,1,2,144,62,86,10,148
Ryan Bonni,6,274,8,36,22,44,1,3,0,0,0,0,2,113,14,50,13,64
Ty Jones,3,158,21,36,40,57,2,14,0,0,3,0,2,106,54,76,25,130
Rasmus Rissanen,5,240,7,29,3,36,1,6,0,0,0,0,2,139,5,22,2,27
Jaroslav Kristek,4,172,38,43,0,81,1,6,0,0,0,0,2,115,64,73,1,137
Roman Tvrdon,4,170,17,21,0,38,1,9,0,1,0,1,2,131,54,78,1,132
Ryan Johansen,1,40,17,16,0,33,4,271,73,94,1,167,2,134,65,96,1,161
Brett Kulak,3,36,5,11,1,16,1,1,0,0,0,0,2,72,9,15,0,24
Ivan Baranka,3,174,13,57,4,70,1,1,0,1,0,1,2,122,10,28,2,38
Jordan Martinook,3,182,38,54,6,92,1,8,0,1,0,1,2,144,51,41,7,92
Stanislav Gron,3,202,48,34,2,82,1,1,0,0,0,0,2,110,37,47,1,84
Colton Sissons,2,138,50,36,1,86,1,17,1,3,0,4,2,121,43,39,4,82
Jonas Johansson,2,93,13,26,0,39,1,1,0,0,0,0,2,98,28,44,0,72
Kyle Freadrich,1,5,0,0,3,0,2,23,0,1,8,1,2,114,8,7,43,15
Morgan Rielly,1,14,1,2,0,3,2,154,10,46,0,56,2,83,9,37,1,46
Roman Wick,1,70,20,22,0,42,1,7,0,0,0,0,2,127,53,65,1,118
Sam Reinhart,1,3,0,3,0,3,1,9,0,1,0,1,2,71,30,34,0,64
Jerred Smithson,7,303,23,78,2,101,11,606,39,57,8,96,3,194,40,56,14,96
Matt Walker,8,240,9,43,31,52,9,314,4,26,54,30,3,197,9,49,37,58
Eric Godard,8,297,11,13,98,24,8,335,6,12,97,18,3,133,5,10,79,15
Scottie Upshall,5,62,32,28,1,60,12,553,115,119,5,234,3,173,99,127,2,226
Steve McCarthy,7,193,14,53,1,67,8,302,17,38,4,55,3,152,43,85,9,128
Quintin Laing,13,692,92,171,22,263,4,79,3,8,1,11,3,197,44,64,7,108
Garnet Exelby,7,457,21,65,61,86,7,408,7,43,30,50,3,189,13,29,17,42
Jamie Lundmark,8,298,89,133,10,222,6,295,40,59,9,99,3,159,96,120,9,216
Trent Hunter,5,297,112,140,4,252,9,497,101,135,2,236,3,177,77,83,4,160
Lawrence Nycholat,10,557,73,260,31,333,4,50,2,7,0,9,3,213,51,137,18,188
Tyler Bouck,8,415,55,113,26,168,5,91,4,8,9,12,3,178,63,84,29,147
Blair Betts,4,180,45,58,0,103,9,477,41,37,0,78,3,157,79,98,2,177
Steve MacIntyre,7,181,3,5,32,8,5,91,2,2,18,4,3,123,3,1,48,4
David Schlemko,5,129,13,51,0,64,7,231,9,41,0,50,3,198,22,109,3,131
Paul Gaustad,3,238,37,100,29,137,11,664,87,138,46,225,3,198,53,82,28,135
Shaone Morrisonn,4,216,15,49,8,64,8,480,11,64,6,75,3,179,25,57,6,82
Jeremy Reich,10,647,116,131,132,247,3,99,2,4,21,6,3,204,86,117,37,203
Nick Tarnasky,6,315,54,45,68,99,5,245,13,17,39,30,3,150,36,43,15,79
Clayton Stoner,5,283,15,65,29,80,6,296,5,34,36,39,3,189,23,70,12,93
Kyle Cumiskey,5,207,21,80,0,101,6,139,9,26,0,35,3,177,12,67,1,79
Marcel Hossa,5,186,74,63,0,137,6,237,31,30,0,61,3,188,65,99,0,164
Steven Goertzen,7,382,46,58,34,104,4,68,2,2,12,4,3,206,33,46,18,79
Clarke MacArthur,3,163,56,102,4,158,9,544,133,171,4,304,3,190,88,136,8,224
Brad Moran,8,523,151,270,1,421,3,8,1,2,0,3,3,215,161,179,1,340
Micki DuPont,6,414,69,173,4,242,4,23,1,3,0,4,3,200,47,130,7,177
Stephen Peat,6,68,3,4,15,7,4,130,8,2,35,10,3,134,8,28,36,36
D.J. King,4,144,10,15,29,25,6,118,4,7,33,11,3,183,38,48,40,86
Michael Grabner,4,180,68,52,0,120,6,317,95,60,0,155,3,180,88,41,0,129
Darren Helm,3,124,29,39,0,68,8,366,59,77,0,136,3,201,76,91,3,167
Brooks Laich,2,75,22,27,0,49,11,683,132,185,5,317,3,206,78,124,1,202
Joffrey Lupul,2,6,4,5,0,9,11,655,194,212,10,406,3,191,127,113,2,240
Luca Sbisa,3,14,3,10,0,13,7,342,12,55,13,67,3,109,14,52,7,66
Ryan Reaves,4,214,20,25,47,45,5,275,17,17,48,34,3,201,36,43,7,79
Andrew Ladd,2,27,12,8,2,20,10,691,185,235,16,420,3,137,49,71,12,120
Spencer Machacek,6,415,117,155,20,272,3,25,2,7,1,9,3,203,77,91,10,168
Zdenek Blatny,6,331,66,89,8,155,3,25,3,0,0,3,3,170,102,107,4,209
Michal Repik,4,243,66,116,2,182,4,72,9,11,0,20,3,176,75,93,4,168
Tomas Vincour,4,157,45,45,0,90,4,95,7,10,0,17,3,171,62,61,4,123
Jakub Cutta,5,298,9,34,9,43,3,8,0,0,0,0,3,177,10,23,4,33
Kyle Rossiter,5,349,10,34,24,44,3,11,0,1,1,1,3,195,21,55,31,76
Dale Weise,3,194,57,54,19,111,5,258,23,36,25,59,3,173,51,61,17,112
Matt Calvert,3,128,40,42,7,82,5,209,42,44,10,86,3,198,99,131,11,230
Derek Dorsett,2,71,11,13,29,24,7,410,38,60,89,98,3,180,49,79,42,128
Emerson Etem,4,119,51,41,0,92,3,112,15,16,1,31,3,202,143,109,2,252
Tomas Mojzis,4,226,22,69,3,91,3,17,1,2,0,3,3,198,42,100,5,142
Pavel Brendl,3,160,51,56,0,107,4,78,11,11,0,22,3,178,172,148,3,320
Chris Nielsen,5,306,40,64,3,104,2,52,6,8,0,14,3,200,82,84,1,166
Darren Reid,5,203,41,41,17,82,2,21,0,1,2,1,3,167,55,87,38,142
Jozef Balej,5,227,55,89,2,144,2,18,1,5,0,6,3,176,105,85,1,190
Mike Sauer,3,177,13,33,10,46,3,98,4,14,9,18,3,156,15,52,6,67
Filip Novak,4,245,33,110,6,143,2,17,0,0,0,0,3,171,36,128,11,164
Kurt Sauer,1,4,0,0,0,0,7,357,5,28,11,33,3,180,12,42,8,54
Mario Bliznak,3,214,31,40,0,71,2,6,1,0,0,1,3,183,36,58,1,94
Shaun Heshka,5,354,25,89,3,114,1,8,0,2,0,2,3,204,25,82,3,107
Brandon Davidson,4,150,11,17,5,28,1,12,1,0,0,1,3,200,22,112,7,134
John Persson,4,177,44,30,3,74,1,10,1,0,0,1,3,200,63,67,1,130
Mitch Callahan,4,237,59,52,20,111,1,1,0,0,0,0,3,203,57,71,48,128
Matt Dumba,2,23,5,9,0,14,2,71,9,9,1,18,3,137,35,50,7,85
Ryan Nugent-Hopkins,1,19,8,12,0,20,4,258,65,123,1,188,3,141,57,120,1,177
Dominik Uher,3,193,24,33,16,57,1,2,0,0,0,0,3,181,58,86,14,144
Adam Lowry,2,73,17,17,3,34,1,80,11,12,1,23,3,163,45,71,9,116
David Musil,2,126,4,19,2,23,1,4,0,2,0,2,3,192,19,65,8,84
Denis Tolpeko,2,82,19,28,2,47,1,26,1,5,0,6,3,179,46,65,3,111
Keegan Lowe,2,121,4,19,16,23,1,2,0,0,2,0,3,212,7,54,24,61
Masi Marjamaki,2,153,15,33,4,48,1,1,0,0,0,0,3,179,50,70,6,120
Milan Kytnar,2,91,14,18,1,32,1,1,0,0,0,0,3,172,50,76,4,126
Damon Severson,1,2,0,2,0,2,1,51,5,12,0,17,3,125,11,43,3,54
Derrick Pouliot,1,31,7,17,0,24,1,34,2,5,0,7,3,145,16,74,5,90
Griffin Reinhart,1,59,7,15,0,22,1,8,0,1,0,1,3,105,18,43,3,61
Nolan Yonkman,14,725,21,79,75,100,7,76,1,9,7,10,4,255,12,26,21,38
Blair Jones,9,416,103,169,21,272,8,132,7,10,3,17,4,249,61,112,9,173
Vernon Fiddler,5,204,34,57,6,91,12,736,90,145,17,235,4,267,85,100,11,185
Brett Sutter,8,538,91,139,27,230,7,60,2,8,4,10,4,254,58,80,12,138
Brian Sutherby,6,58,4,18,7,22,9,460,41,49,49,90,4,208,79,99,21,178
Jeff Woywitka,7,274,16,96,8,112,7,278,9,46,5,55,4,268,41,99,13,140
Zach Boychuk,7,335,129,158,2,287,7,127,12,18,0,30,4,237,110,161,1,271
Adam Cracknell,9,415,97,123,9,220,5,82,6,11,0,17,4,283,94,119,14,213
Colin Fraser,5,286,53,72,42,125,9,359,20,38,31,58,4,269,74,140,59,214
Jim Vandermeer,5,230,15,40,28,55,9,461,25,80,45,105,4,248,34,100,53,134
Brendan Mikkelson,8,329,35,92,8,127,5,131,1,9,3,10,4,226,16,54,9,70
Troy Bodie,8,381,56,54,75,110,5,159,9,12,26,21,4,250,64,65,38,129
Jeremy Williams,7,328,138,124,4,262,5,32,9,2,0,11,4,174,99,108,1,207
Kyle Wanvig,7,394,114,131,49,245,5,75,6,9,4,15,4,266,107,98,29,205
Kris Beech,5,226,89,122,0,211,7,198,25,42,0,67,4,232,90,164,1,254
Boyd Gordon,3,103,21,41,0,62,11,628,53,103,1,156,4,260,77,130,4,207
Colby Armstrong,4,243,34,55,8,89,8,476,89,120,13,209,4,205,76,109,10,185
Gilbert Brule,4,93,33,31,6,64,8,299,43,52,4,95,4,165,87,98,8,185
Jeff Schultz,4,164,7,34,1,41,8,408,11,65,1,76,4,262,22,85,1,107
Dane Byers,10,564,128,177,95,305,3,14,1,0,4,1,4,236,49,50,39,99
Jeremy Colliton,6,325,77,125,4,202,5,57,3,3,0,6,4,229,71,105,5,176
Jon Blum,6,336,42,137,2,179,5,110,7,17,0,24,4,248,49,155,3,204
Rob Klinkhammer,6,396,82,129,8,211,5,179,21,21,2,42,4,230,57,67,10,124
Dustin Byfuglien,3,123,26,48,7,74,10,597,133,211,12,344,4,189,48,94,12,142
Matt Kassian,7,231,10,12,69,22,4,76,4,1,23,5,4,245,17,19,66,36
Zack Smith,4,171,46,57,22,103,7,319,39,39,27,78,4,221,41,68,26,109
Barret Jackman,2,76,2,12,23,14,13,803,28,153,55,181,4,234,28,111,57,139
Keith Aulie,5,138,8,17,11,25,5,167,4,10,15,14,4,234,12,49,9,61
Nigel Dawes,5,232,117,116,4,233,5,212,39,45,2,84,4,245,159,113,3,272
Justin Falk,4,228,7,26,10,33,6,147,2,17,12,19,4,191,7,44,9,51
Keaton Ellerby,4,191,14,49,0,63,6,212,4,23,3,27,4,266,6,54,19,60
Rick Rypien,4,108,15,22,20,37,6,119,9,7,29,16,4,179,47,67,31,114
Cody McLeod,3,132,21,19,34,40,8,549,57,46,109,103,4,257,69,68,53,137
Ian White,3,108,12,52,1,64,8,503,45,134,5,179,4,246,77,145,1,222
Kris Versteeg,3,139,46,81,10,127,8,473,116,159,9,275,4,264,62,105,9,167
Nate Thompson,3,216,35,45,21,80,8,471,44,59,16,103,4,253,55,88,6,143
Dan Hamhuis,2,136,12,42,2,54,11,814,52,238,9,290,4,247,34,122,13,156
Jordin Tootoo,2,92,19,26,15,45,11,607,59,90,88,149,4,220,93,116,51,209
Travis Moen,2,84,2,4,12,6,11,724,59,75,76,134,4,181,27,31,30,58
Brandon Sutter,3,36,6,12,0,18,7,495,98,87,6,185,4,205,68,86,4,154
Colby Robak,5,297,30,83,0,113,4,47,0,4,0,4,4,246,37,106,3,143
Colton Gillies,5,282,33,56,12,89,4,154,6,12,2,18,4,195,44,47,7,91
Riley Cote,5,128,4,5,45,9,4,156,1,6,53,7,4,235,54,67,27,121
Brandon McMillan,4,160,35,40,2,75,5,171,14,22,0,36,4,250,55,113,4,168
Dustin Boyd,4,136,51,49,0,100,5,220,32,31,1,63,4,265,103,114,6,217
Josh Gorges,2,25,2,4,0,6,10,606,14,90,7,104,4,245,33,119,7,152
Carson McMillan,6,351,45,50,19,95,3,16,2,3,1,5,4,271,57,84,17,141
Ty Wishart,6,326,26,83,8,109,3,26,1,5,0,6,4,262,33,128,8,161
Brayden Schenn,3,47,22,30,1,52,6,274,58,76,11,134,4,224,116,199,11,315
Steve Regier,4,288,76,102,2,178,4,26,3,1,0,4,4,193,37,49,12,86
Devin Setoguchi,2,42,11,18,1,29,8,471,127,122,4,249,4,255,118,125,10,243
Lynn Loyns,5,264,43,48,13,91,3,34,3,2,1,5,4,258,72,113,8,185
Matthew Spiller,5,316,7,32,32,39,3,68,0,2,4,2,4,271,24,64,22,88
Ryan Stone,5,309,60,130,28,190,3,35,0,7,5,7,4,239,78,162,23,240
Jordan Eberle,3,54,34,40,0,74,5,356,120,164,0,284,4,254,155,155,0,310
Dean Arsene,12,618,15,80,79,95,1,13,0,0,3,0,4,276,8,40,36,48
Shane Endicott,6,354,67,106,1,173,2,45,1,2,1,3,4,219,72,101,1,173
Brandon Manning,4,244,31,83,36,114,3,21,0,5,1,5,4,200,45,91,24,136
Cody Almond,4,164,29,38,24,67,3,25,2,0,2,2,4,229,72,96,13,168
Max Reinhart,4,203,45,80,0,125,3,23,1,4,0,5,4,266,94,141,2,235
Brenden Dillon,3,123,9,34,8,43,4,209,11,24,13,35,4,280,11,83,22,94
Michael Stone,3,157,17,46,1,63,4,204,17,34,0,51,4,264,52,129,6,181
Jay Bouwmeester,1,2,0,1,0,1,12,918,78,279,1,357,4,194,40,111,0,151
Justin Mapletoft,5,320,67,107,4,174,2,38,3,6,0,9,4,279,115,160,9,275
Travis Hamonic,2,40,6,11,7,17,5,323,18,93,12,111,4,181,29,80,14,109
Ryan Getzlaf,1,17,8,25,0,33,10,710,208,470,23,678,4,233,95,120,11,215
Shea Weber,1,45,12,15,3,27,10,685,146,246,20,392,4,190,26,65,18,91
Zack Fitzgerald,9,447,11,38,117,49,1,1,0,0,0,0,4,248,22,54,46,76
Brandon Dubinsky,1,71,21,22,8,43,9,545,112,207,38,319,4,234,82,148,25,230
Brett Bulmer,4,145,20,24,11,44,2,14,0,3,0,3,4,178,65,86,15,151
Dylan McIlrath,4,182,12,27,40,39,2,3,0,0,2,0,4,232,16,58,48,74
Jordan Krestanovich,4,258,44,80,1,124,2,22,0,2,0,2,4,226,66,97,0,163
Mike Funk,4,151,4,23,3,27,2,9,0,2,0,2,4,280,23,98,8,121
Brett Connolly,2,137,52,68,1,120,4,139,18,16,2,34,4,144,86,66,0,152
Kris Russell,1,14,3,5,0,8,8,511,34,124,8,158,4,241,76,120,6,196
Grant McNeill,7,124,5,3,63,8,1,3,0,0,1,0,4,260,11,21,61,32
Brodie Dupont,6,364,66,102,29,168,1,1,0,0,0,0,4,214,81,68,22,149
Ryan Russell,6,336,70,61,2,131,1,41,2,0,0,2,4,263,98,118,8,216
Mark Stone,2,91,30,49,0,79,3,103,30,42,0,72,4,232,106,190,4,296
Derek Boogaard,1,53,0,4,24,4,6,277,3,13,62,16,4,174,3,18,70,21
Tyler Ennis,1,69,23,42,0,65,6,345,89,123,1,212,4,245,115,121,2,236
Brandon Kozun,5,319,91,116,0,207,1,20,2,2,0,4,4,217,92,178,0,270
Brett Lysak,5,226,35,44,5,79,1,2,0,0,0,0,4,265,134,175,8,309
Dustin Kohn,5,212,11,50,5,61,1,22,0,4,0,4,4,253,20,111,3,131
Jesse Schultz,5,305,103,125,2,228,1,2,0,0,0,0,4,272,110,119,6,229
Layne Ulmer,5,311,65,87,0,152,1,1,0,0,0,0,4,261,161,154,5,315
Ryan Keller,5,284,102,98,2,200,1,6,0,0,0,0,4,257,120,117,4,237
Scott Glennie,5,230,46,72,1,118,1,1,0,0,0,0,4,252,121,187,8,308
Brody Sutter,4,141,24,35,5,59,1,4,0,0,0,0,4,231,57,68,9,125
Owen Fussey,4,137,9,18,4,27,1,4,0,1,0,1,4,237,106,73,3,179
Ross Lupaschuk,4,278,49,73,27,122,1,3,0,0,0,0,4,267,63,104,30,167
Ty Rattie,2,131,52,38,1,90,2,13,0,2,0,2,4,207,103,135,1,238
Tyler Wotherspoon,2,109,3,30,0,33,2,15,0,4,0,4,4,178,10,35,4,45
Dave Morisset,3,122,15,16,6,31,1,4,0,0,1,0,4,196,65,72,16,137
Duncan Siemens,3,103,1,9,8,10,1,1,0,0,0,0,4,188,14,78,19,92
Mike Card,3,92,2,13,1,15,1,4,0,0,0,0,4,269,35,112,4,147
Patrick Holland,3,147,16,31,0,47,1,5,0,0,0,0,4,203,63,144,5,207
Brendan Gallagher,1,36,10,10,3,20,3,207,58,58,4,116,4,244,136,144,11,280
Colin Smith,2,129,20,45,0,65,1,1,0,0,0,0,4,200,61,104,4,165
Shay Stephenson,2,61,11,10,0,21,1,2,0,0,0,0,4,230,38,48,7,86
Colton Orr,5,106,2,4,42,6,11,477,12,12,123,24,5,164,19,9,54,28
Jason Jaffray,13,560,179,270,24,449,4,49,4,7,5,11,5,277,107,128,18,235
Brandon Segal,10,593,159,158,38,317,5,103,11,11,9,22,5,286,110,96,21,206
Derek Meech,8,377,36,129,0,165,6,144,4,13,1,17,5,263,27,70,4,97
Mike Wilson,8,290,22,49,14,71,6,201,10,24,5,34,5,175,19,79,1,98
Garth Murray,9,482,61,87,82,148,5,116,8,2,19,10,5,266,78,77,62,155
Frazer McLaren,8,245,13,18,67,31,5,102,4,7,36,11,5,318,56,47,68,103
Johnny Boychuk,5,294,45,108,20,153,8,393,28,82,10,110,5,266,38,95,21,133
Kyle Chipchura,5,186,41,63,14,104,8,412,27,65,43,92,5,216,59,106,15,165
Mark Fistric,5,182,4,40,4,44,8,325,4,30,12,34,5,214,11,47,21,58
Deryk Engelland,6,339,14,42,63,56,6,319,15,43,45,58,5,243,14,34,60,48
Brett Carson,7,321,25,102,0,127,5,90,2,11,0,13,5,268,28,82,1,110
Cam Barker,4,93,19,28,7,47,8,310,21,75,11,96,5,213,51,128,11,179
Dana Tyrell,6,232,47,71,2,118,5,135,7,17,0,24,5,240,81,98,6,179
Nathan Paetsch,6,382,41,139,9,180,5,167,7,35,4,42,5,258,48,164,13,212
Ryan Hollweg,6,202,18,22,29,40,5,228,5,9,27,14,5,233,94,139,16,233
Drayson Bowman,5,248,70,73,7,143,6,179,15,18,1,33,5,263,129,112,13,241
Eric Fehr,3,120,50,51,2,101,10,454,89,88,0,177,5,279,146,131,3,277
Ben Ondrus,7,394,65,72,36,137,4,52,0,2,10,2,5,316,94,113,18,207
Erik Christensen,4,75,40,35,0,75,7,387,68,95,0,163,5,338,133,153,0,286
Blake Comeau,3,111,20,61,4,81,9,483,88,107,4,195,5,253,60,117,13,177
Troy Brouwer,3,146,78,63,11,141,9,531,132,123,25,255,5,287,103,116,15,219
Nick Drazenovic,8,469,121,194,4,315,3,12,0,0,0,0,5,281,77,137,3,214
Kenndal McArdle,6,250,47,44,20,91,4,42,1,2,7,3,5,261,92,111,23,203
Matt Keith,6,422,104,100,5,204,4,27,2,3,0,5,5,203,76,78,8,154
Jarret Stoll,2,152,42,66,0,108,12,792,140,239,0,379,5,245,124,162,0,286
Zach Hamill,7,349,66,126,1,192,3,20,0,4,0,4,5,250,87,175,1,262
Triston Grant,10,633,73,80,139,153,2,11,0,1,3,1,5,291,52,35,99,87
Ben Maxwell,5,301,68,140,1,208,4,47,2,6,1,8,5,210,64,95,5,159
Colton Sceviour,5,348,99,141,8,240,4,99,17,22,1,39,5,251,78,114,10,192
Dwight King,4,202,50,74,9,124,5,238,37,43,2,80,5,273,79,110,9,189
Paul Postma,4,215,47,89,0,136,5,100,7,11,0,18,5,270,44,117,0,161
Braydon Coburn,2,88,7,30,7,37,10,618,37,131,10,168,5,238,29,102,18,131
Kyle Brodziak,2,117,36,51,1,87,10,621,98,130,12,228,5,273,81,104,16,185
Shawn Belle,6,362,19,65,10,84,3,20,0,1,0,1,5,253,30,87,6,117
Cody Franson,3,158,24,71,1,95,6,400,35,134,0,169,5,199,34,85,5,119
Matt Fraser,4,181,90,41,5,131,4,87,11,6,3,17,5,265,87,87,37,174
Stefan Elliott,4,199,43,52,0,95,4,63,6,12,0,18,5,282,82,159,2,241
Carter Ashton,5,192,56,47,9,103,3,54,0,3,4,3,5,239,92,89,16,181
Thomas Hickey,5,212,14,61,2,75,3,202,7,41,0,48,5,262,39,137,4,176
Stefan Meyer,7,381,86,79,29,165,2,20,0,2,3,2,5,282,123,123,16,246
Karl Alzner,2,104,7,34,0,41,7,427,12,71,1,83,5,260,19,98,2,117
Carsen Germyn,6,404,100,165,30,265,2,4,0,0,0,0,5,324,116,167,22,283
Alex Petrovic,4,144,9,42,11,51,3,46,0,4,4,4,5,270,29,117,22,146
Alex Plante,4,212,6,37,35,43,3,10,0,2,1,2,5,224,18,71,16,89
Ryan Stanton,4,224,9,51,14,60,3,119,4,23,3,27,5,242,19,83,15,102
Cody Eakin,3,82,27,26,0,53,4,237,46,61,1,107,5,238,118,121,6,239
James Wright,3,196,33,64,9,97,4,146,4,8,6,12,5,202,45,69,5,114
Lance Bouma,3,95,16,11,8,27,4,199,22,31,7,53,5,230,39,76,18,115
Tyson Barrie,3,93,12,52,1,64,4,186,27,77,0,104,5,255,51,177,4,228
Landon Ferraro,5,270,75,65,10,140,2,7,1,0,0,1,5,220,76,76,17,152
Ray Macias,5,178,18,47,0,65,2,8,0,1,0,1,5,280,66,118,0,184
Brayden McNabb,3,159,20,82,6,102,3,108,3,29,5,32,5,258,50,126,24,176
Mark Pysyk,3,142,8,39,0,47,3,70,4,11,0,15,5,243,25,100,5,125
Craig Cunningham,4,247,75,69,1,144,2,53,3,4,0,7,5,330,103,161,7,264
Cam Paddock,7,284,37,37,21,74,1,16,2,1,0,3,5,323,107,98,27,205
Carter Bancks,6,281,21,45,21,66,1,2,0,0,0,0,5,262,58,120,15,178
Jared Aulin,6,236,55,116,0,171,1,17,2,2,0,4,5,230,88,168,6,256
John Negrin,6,177,7,26,3,33,1,3,0,1,0,1,5,235,13,104,5,117
Linden Vey,3,191,55,103,0,158,2,93,10,19,0,29,5,262,102,178,1,280
Quinton Howden,3,149,26,49,0,75,2,34,4,2,0,6,5,244,111,128,0,239
Duncan Milroy,5,344,72,110,1,182,1,5,0,1,0,1,5,264,132,155,2,287
Wade Skolney,5,310,6,33,45,39,1,1,0,0,0,0,5,172,10,44,19,54
Jared Cowen,1,3,0,3,0,3,5,212,15,27,8,42,5,239,37,82,12,119
Jared Spurgeon,1,23,2,7,0,9,5,295,26,75,0,101,5,264,37,132,1,169
Curtis Hamilton,4,208,30,38,3,68,1,1,0,0,0,0,5,216,67,106,1,173
Kris Foucault,4,157,30,35,1,65,1,1,0,0,0,0,5,195,56,55,5,111
Brendan Shinnimin,3,190,47,61,6,108,1,12,0,1,0,1,5,266,131,206,9,337
Colten Teubert,3,167,10,27,12,37,1,24,0,1,1,1,5,263,32,81,29,113
Doug Lynch,3,161,12,29,12,41,1,2,0,0,0,0,5,266,55,87,40,142
Joe Morrow,3,155,14,46,2,60,1,15,1,0,0,1,5,227,33,118,14,151
Matt Konan,3,74,2,6,0,8,1,2,0,0,0,0,5,301,19,88,17,107
Brendan Ranford,2,138,30,54,0,84,1,1,0,0,0,0,5,278,115,155,6,270
Ryan Craig,9,500,125,152,32,277,8,198,32,31,14,63,6,302,137,131,15,268
Aaron Rome,7,260,31,83,17,114,8,226,6,22,9,28,6,304,31,124,27,155
Warren Peters,12,635,119,104,29,223,4,96,4,4,4,8,6,330,111,107,15,218
Nathan Smith,9,471,89,123,22,212,5,26,0,0,2,0,6,240,76,137,16,213
Aaron Gagnon,6,328,74,98,0,172,4,38,3,2,0,5,6,318,123,121,2,244
Brett Festerling,5,241,9,51,6,60,4,88,0,8,1,8,6,314,15,54,1,69
Victor Bartley,4,148,18,49,1,67,3,111,1,22,3,23,6,336,36,132,15,168
Jason MacDonald,7,364,59,68,92,127,1,4,0,0,1,0,6,184,14,18,2,32
Jonathan Filewich,4,292,69,73,2,142,1,5,0,0,0,0,6,321,121,125,5,246
Scott Jackson,4,240,2,30,17,32,1,1,0,0,0,0,6,329,23,96,8,119
Richie Regehr,2,70,12,32,0,44,2,20,1,3,0,4,6,307,49,150,9,199
Mike Brown,9,457,55,67,132,122,12,383,18,16,106,34,7,312,66,63,71,129
Mike Green,8,342,88,149,1,237,11,599,114,250,2,364,8,478,130,255,11,385
Ryan White,5,190,36,47,27,83,6,175,11,18,23,29,8,499,104,196,22,300
Tyler Johnson,2,137,68,65,2,133,3,173,56,72,0,128,9,520,167,207,12,374
Alexandre Picard,11,528,135,191,21,326,12,320,19,52,6,71,0,0,0,0,0,0
Nolan Baumgartner,14,851,80,306,14,386,9,142,7,40,1,47,0,0,0,0,0,0
Shawn Thornton,10,584,67,93,213,160,12,605,39,54,136,93,0,0,0,0,0,0
Keith Aucoin,13,775,248,617,6,865,9,145,17,32,0,49,0,0,0,0,0,0
Brett Clark,8,392,45,131,1,176,14,689,45,141,1,186,0,0,0,0,0,0
Derek MacKenzie,9,551,148,183,11,331,12,389,36,46,14,82,0,0,0,0,0,0
Jeff Taffe,12,710,238,338,8,576,9,180,21,25,0,46,0,0,0,0,0,0
Bryan Helmer,15,798,92,329,23,421,7,146,8,18,5,26,0,0,0,0,0,0
Tom Kostopoulos,9,549,159,248,35,407,11,630,61,96,69,157,0,0,0,0,0,0
Wyatt Smith,12,566,167,233,6,400,8,211,10,22,1,32,0,0,0,0,0,0
Brian Willsie,9,547,197,229,1,426,10,381,52,57,3,109,0,0,0,0,0,0
Chris Conner,10,413,126,204,1,330,9,180,22,27,0,49,0,0,0,0,0,0
Toby Petersen,10,552,165,247,0,412,9,398,33,48,0,81,0,0,0,0,0,0
Kris Newbury,11,675,174,349,80,523,8,76,4,6,14,10,0,0,0,0,0,0
Daniel Briere,5,172,89,133,0,222,17,973,307,389,4,696,0,0,0,0,0,0
Denis Hamel,12,818,326,294,41,620,7,192,19,12,5,31,0,0,0,0,0,0
Jon Sim,7,211,87,102,2,189,12,469,75,64,4,139,0,0,0,0,0,0
Mathieu Darche,9,549,215,238,2,453,9,250,30,42,0,72,0,0,0,0,0,0
Mike Mottau,9,514,50,254,9,304,9,321,7,51,6,58,0,0,0,0,0,0
Doug Janik,10,612,42,164,32,206,8,190,3,16,8,19,0,0,0,0,0,0
Mike Blunden,10,412,96,113,26,209,8,104,4,4,7,8,0,0,0,0,0,0
Rory Fitzpatrick,10,428,35,110,15,145,8,237,10,22,4,32,0,0,0,0,0,0
Stephane Veilleux,8,366,66,95,12,161,10,506,50,56,21,106,0,0,0,0,0,0
Sean Collins,13,548,53,132,6,185,6,40,2,4,0,6,0,0,0,0,0,0
Dennis Bonvie,11,598,59,121,246,180,7,82,1,2,36,3,0,0,0,0,0,0
Derek Armstrong,7,315,128,223,6,351,11,407,65,139,9,204,0,0,0,0,0,0
Jason Williams,7,366,131,182,2,313,11,455,94,133,2,227,0,0,0,0,0,0
Mike Commodore,7,261,13,47,20,60,11,484,23,83,34,106,0,0,0,0,0,0
Mike Zigomanis,11,535,137,274,0,411,7,197,21,19,0,40,0,0,0,0,0,0
Tim Jackman,7,412,90,79,51,169,11,481,32,43,100,75,0,0,0,0,0,0
Mike Ribeiro,5,106,35,56,0,91,15,947,217,501,5,718,0,0,0,0,0,0
Brad Larsen,9,334,73,103,18,176,8,294,19,29,6,48,0,0,0,0,0,0
Bryan Muir,8,361,57,119,19,176,9,274,16,37,8,53,0,0,0,0,0,0
Craig MacDonald,9,345,91,169,3,260,8,233,11,24,1,35,0,0,0,0,0,0
Jason Ward,9,365,122,166,12,288,8,336,36,45,3,81,0,0,0,0,0,0
Jay Harrison,8,420,36,82,28,118,9,372,23,52,24,75,0,0,0,0,0,0
John Erskine,6,153,6,24,35,30,12,491,15,39,67,54,0,0,0,0,0,0
Matt Ellis,8,362,82,100,1,182,9,356,21,28,1,49,0,0,0,0,0,0
Ron Hainsey,6,208,22,83,1,105,12,754,40,177,8,217,0,0,0,0,0,0
Anders Eriksson,7,271,21,136,0,157,10,548,22,148,0,170,0,0,0,0,0,0
Bryan Allen,5,128,9,26,8,35,14,721,29,107,50,136,0,0,0,0,0,0
Francis Bouillon,5,179,29,74,11,103,14,776,32,117,28,149,0,0,0,0,0,0
Jason Krog,10,544,193,412,1,605,7,202,22,37,0,59,0,0,0,0,0,0
Kurtis Foster,7,283,52,99,8,151,10,405,42,118,5,160,0,0,0,0,0,0
Marty Reasoner,5,126,57,72,2,129,14,798,97,169,3,266,0,0,0,0,0,0
Matt Carkner,10,512,35,101,86,136,7,237,4,23,56,27,0,0,0,0,0,0
Alexandre Giroux,11,761,355,330,17,685,6,48,6,6,1,12,0,0,0,0,0,0
Joe Corvo,6,269,45,115,2,160,11,708,92,218,2,310,0,0,0,0,0,0
Mike Rupp,6,251,40,51,6,91,11,610,54,45,82,99,0,0,0,0,0,0
Mark Eaton,5,133,20,45,0,65,13,650,24,61,0,85,0,0,0,0,0,0
Mike Weaver,5,209,10,29,4,39,13,633,8,89,5,97,0,0,0,0,0,0
Steve Begin,5,214,41,38,22,79,13,524,56,52,32,108,0,0,0,0,0,0
Aaron Johnson,8,324,30,132,4,162,8,291,17,45,5,62,0,0,0,0,0,0
Steve Kelly,8,396,112,232,18,344,8,141,8,12,3,20,0,0,0,0,0,0
Steve Martins,8,380,89,196,0,285,8,242,20,21,3,41,0,0,0,0,0,0
Sven Butenschon,8,392,70,155,17,225,8,140,2,12,2,14,0,0,0,0,0,0
Aaron Downey,7,359,29,50,107,79,9,243,8,10,50,18,0,0,0,0,0,0
Brian McGrattan,7,266,38,41,82,79,9,317,10,17,75,27,0,0,0,0,0,0
John Mitchell,9,437,86,106,13,192,7,412,57,92,2,149,0,0,0,0,0,0
Kent Huskins,9,540,34,117,2,151,7,318,13,55,3,68,0,0,0,0,0,0
Tim Sestito,9,442,74,93,32,167,7,101,0,8,5,8,0,0,0,0,0,0
Zenon Konopka,7,279,86,138,57,224,9,346,12,18,117,30,0,0,0,0,0,0
Alex Bolduc,10,432,113,147,19,260,6,65,2,3,2,5,0,0,0,0,0,0
Andreas Lilja,5,103,8,37,1,45,12,580,16,71,13,87,0,0,0,0,0,0
Carlo Colaiacovo,5,84,11,35,1,46,12,434,33,119,9,152,0,0,0,0,0,0
Cody McCormick,6,191,37,41,23,78,10,405,21,44,62,65,0,0,0,0,0,0
Francis Lessard,12,616,29,48,228,77,5,115,1,3,34,4,0,0,0,0,0,0
Jassen Cullimore,5,124,10,24,3,34,12,699,22,76,10,98,0,0,0,0,0,0
Jody Shelley,5,139,6,17,68,23,12,627,18,36,175,54,0,0,0,0,0,0
Marc-Andre Bergeron,6,215,24,90,2,114,10,490,82,153,6,235,0,0,0,0,0,0
Mathieu Roy,10,317,23,89,37,112,6,66,2,11,5,13,0,0,0,0,0,0
Sean Avery,6,139,38,36,26,74,10,580,90,157,88,247,0,0,0,0,0,0
Wade Brookbank,12,391,8,19,109,27,5,127,6,3,45,9,0,0,0,0,0,0
Andrew Ebbett,7,335,106,214,1,320,8,224,26,45,0,71,0,0,0,0,0,0
Bryce Salvador,4,172,7,35,22,42,14,786,24,86,42,110,0,0,0,0,0,0
Jean-Francois Jacques,8,308,88,98,34,186,7,166,9,8,21,17,0,0,0,0,0,0
Jed Ortmeyer,7,266,49,71,2,120,8,345,22,31,4,53,0,0,0,0,0,0
Joel Bouchard,7,155,28,69,0,97,8,282,18,48,7,66,0,0,0,0,0,0
Jonathan Cheechoo,8,331,123,152,1,275,7,501,170,135,2,305,0,0,0,0,0,0
Mark Fraser,8,326,8,52,40,60,7,219,4,18,30,22,0,0,0,0,0,0
Nate Guenin,7,441,18,89,19,107,8,176,5,23,2,28,0,0,0,0,0,0
Pascal Rheaume,7,259,66,101,5,167,8,316,38,52,10,90,0,0,0,0,0,0
Sheldon Brookbank,7,370,30,96,71,126,8,351,7,37,47,44,0,0,0,0,0,0
Tyson Strachan,8,276,16,71,24,87,7,184,1,19,17,20,0,0,0,0,0,0
Francois Beauchemin,5,339,34,86,16,120,11,673,60,159,10,219,0,0,0,0,0,0
Jay Leach,11,446,21,56,41,77,5,70,1,2,8,3,0,0,0,0,0,0
Kip Brennan,11,311,22,18,128,40,5,61,1,1,22,2,0,0,0,0,0,0
Rob Scuderi,5,300,10,79,6,89,11,720,8,92,1,100,0,0,0,0,0,0
Ben Eager,6,136,12,18,25,30,9,407,43,42,64,85,0,0,0,0,0,0
Cam Janssen,6,133,3,12,41,15,9,336,6,8,95,14,0,0,0,0,0,0
Dan LaCouture,6,279,65,49,19,114,9,337,20,25,50,45,0,0,0,0,0,0
David Van der Gulik,9,535,137,170,6,307,6,49,2,11,0,13,0,0,0,0,0,0
Jesse Boulerice,9,394,29,39,113,68,6,172,8,2,42,10,0,0,0,0,0,0
"Jon ""Bates"" Battaglia",6,291,71,134,2,205,9,580,80,118,7,198,0,0,0,0,0,0
Pat Rissmiller,9,556,121,242,3,363,6,192,18,28,0,46,0,0,0,0,0,0
Ryan Potulny,9,433,152,161,1,313,6,126,22,27,0,49,0,0,0,0,0,0
Zack Stortini,9,442,43,45,110,88,6,257,14,27,82,41,0,0,0,0,0,0
Trevor Gillies,13,385,9,13,151,22,4,57,2,1,17,3,0,0,0,0,0,0
Alain Nasreddine,10,629,29,93,42,122,5,74,1,4,2,5,0,0,0,0,0,0
Chris Taylor,10,522,139,348,2,487,5,127,11,17,0,28,0,0,0,0,0,0
Cody Bass,10,331,37,52,77,89,5,49,2,3,13,5,0,0,0,0,0,0
Danny Syvret,10,633,61,259,3,320,5,59,3,4,0,7,0,0,0,0,0,0
Donald MacLean,10,529,232,256,3,488,5,41,8,5,0,13,0,0,0,0,0,0
Jeff Hoggan,10,641,149,155,18,304,5,107,2,9,6,11,0,0,0,0,0,0
Mark Mancari,10,692,225,334,18,559,5,42,3,10,1,13,0,0,0,0,0,0
Shawn Bates,5,111,47,49,0,96,10,465,72,126,2,198,0,0,0,0,0,0
Steve Montador,5,161,14,39,15,53,10,571,33,98,67,131,0,0,0,0,0,0
Andy Delmore,7,394,66,160,2,226,7,283,43,58,0,101,0,0,0,0,0,0
Brad Winchester,7,259,75,64,18,139,7,390,37,31,50,68,0,0,0,0,0,0
Corey Potter,7,352,28,122,4,150,7,129,8,24,0,32,0,0,0,0,0,0
Eric Boguniecki,7,320,141,177,7,318,7,178,34,42,0,76,0,0,0,0,0,0
Jake Dowell,7,381,38,80,57,118,7,157,11,22,20,33,0,0,0,0,0,0
Jeremy Stevenson,7,165,44,39,47,83,7,199,19,18,49,37,0,0,0,0,0,0
Jim Campbell,7,348,112,164,3,276,7,201,36,52,3,88,0,0,0,0,0,0
Rob Davison,7,424,14,46,67,60,7,219,3,15,29,18,0,0,0,0,0,0
Tom Sestito,7,256,48,65,63,113,7,137,10,8,42,18,0,0,0,0,0,0
Alexei Ponikarovsky,4,247,81,95,1,176,12,678,139,184,3,323,0,0,0,0,0,0
Andy Hilbert,6,255,108,121,4,229,8,307,42,62,4,104,0,0,0,0,0,0
Benoit Gratton,8,411,133,289,10,422,6,58,6,10,2,16,0,0,0,0,0,0
Brent Sopel,4,208,27,86,13,113,12,659,44,174,8,218,0,0,0,0,0,0
Brian Lee,8,203,11,51,15,62,6,209,5,31,5,36,0,0,0,0,0,0
Brooks Orpik,4,223,10,46,5,56,12,781,13,138,12,151,0,0,0,0,0,0
Colin Forbes,6,307,92,146,6,238,8,308,32,28,11,60,0,0,0,0,0,0
Dan Boyle,3,117,22,77,5,99,16,1019,153,428,11,581,0,0,0,0,0,0
Eric Belanger,4,167,48,87,0,135,12,820,138,220,0,358,0,0,0,0,0,0
Jason Doig,8,282,16,94,24,110,6,143,5,17,16,22,0,0,0,0,0,0
Jeff Cowan,6,367,68,66,37,134,8,413,47,34,62,81,0,0,0,0,0,0
John Jakopin,8,270,15,49,49,64,6,113,1,6,13,7,0,0,0,0,0,0
Krys Barch,6,251,25,48,52,73,8,381,12,23,113,35,0,0,0,0,0,0
Krys Kolanos,8,322,154,148,4,302,6,149,20,22,0,42,0,0,0,0,0,0
Landon Wilson,6,135,68,46,18,114,8,319,44,54,19,98,0,0,0,0,0,0
Manny Malhotra,3,48,6,11,5,17,16,991,116,179,14,295,0,0,0,0,0,0
Martin St. Louis,3,95,58,56,0,114,16,1134,391,642,0,1033,0,0,0,0,0,0
Martin St. Pierre,8,569,157,412,3,569,6,39,3,5,0,8,0,0,0,0,0,0
Randy Jones,6,152,13,51,5,64,8,365,20,85,3,105,0,0,0,0,0,0
Ray Schultz,8,428,10,58,57,68,6,45,0,4,15,4,0,0,0,0,0,0
Rico Fata,6,249,110,115,5,225,8,230,27,36,2,63,0,0,0,0,0,0
Scott Nichol,4,130,35,42,10,77,12,660,56,71,52,127,0,0,0,0,0,0
Ben Guite,9,588,107,176,6,283,5,175,19,26,1,45,0,0,0,0,0,0
Brian Campbell,3,177,11,84,0,95,15,920,76,380,3,456,0,0,0,0,0,0
Jamie Rivers,5,201,20,81,0,101,9,436,15,44,3,59,0,0,0,0,0,0
Jay Rosehill,9,424,28,39,103,67,5,117,5,3,34,8,0,0,0,0,0,0
Joey Crabb,9,439,106,134,15,240,5,179,20,33,6,53,0,0,0,0,0,0
Pierre-Luc Leblond,9,396,25,34,135,59,5,41,0,3,12,3,0,0,0,0,0,0
Ryan Murphy,15,492,71,123,5,194,3,89,6,19,0,25,0,0,0,0,0,0
Stephane Robidas,3,234,32,85,1,117,15,937,57,201,10,258,0,0,0,0,0,0
Trevor Smith,9,453,153,193,4,346,5,106,9,11,0,20,0,0,0,0,0,0
Adam Hall,4,87,18,27,1,45,11,682,69,87,15,156,0,0,0,0,0,0
Adam Mair,4,172,53,67,14,120,11,615,38,76,51,114,0,0,0,0,0,0
Alex Henry,11,636,16,71,81,87,4,177,2,9,29,11,0,0,0,0,0,0
Boyd Devereaux,4,96,24,27,0,51,11,627,67,112,1,179,0,0,0,0,0,0
Chris Clark,4,175,47,61,26,108,11,607,103,111,39,214,0,0,0,0,0,0
Chris Kelly,4,239,52,50,2,102,11,740,116,159,7,275,0,0,0,0,0,0
Darren Haydar,11,796,297,516,0,813,4,23,1,7,0,8,0,0,0,0,0,0
Jason Morgan,11,593,116,233,12,349,4,41,2,5,0,7,0,0,0,0,0,0
Jason Pominville,4,230,79,79,0,158,11,752,237,342,2,579,0,0,0,0,0,0
Michael Ryder,4,249,85,92,0,177,11,806,237,247,1,484,0,0,0,0,0,0
Mike Hoffman,11,486,91,122,68,213,4,108,30,24,0,54,0,0,0,0,0,0
Mike Komisarek,4,137,12,57,9,69,11,551,14,67,26,81,0,0,0,0,0,0
Tomas Plekanec,4,229,61,97,0,158,11,761,202,297,0,499,0,0,0,0,0,0
Adam Pardy,6,185,9,30,4,39,7,315,4,44,6,48,0,0,0,0,0,0
Bill Thomas,7,388,115,136,1,251,6,87,16,12,0,28,0,0,0,0,0,0
Chris McAllister,6,141,3,8,20,11,7,301,4,17,60,21,0,0,0,0,0,0
Chris Porter,7,322,55,85,12,140,6,173,11,16,3,27,0,0,0,0,0,0
Eric Boulton,3,112,5,5,44,10,14,648,31,48,153,79,0,0,0,0,0,0
Eric Nickulas,7,347,112,129,5,241,6,118,15,23,0,38,0,0,0,0,0,0
Jason Holland,7,449,38,151,5,189,6,77,3,5,0,8,0,0,0,0,0,0
Jean-Luc Grand-Pierre,7,264,19,24,34,43,6,269,7,13,27,20,0,0,0,0,0,0
Joel Perrault,7,282,91,119,0,210,6,96,12,14,2,26,0,0,0,0,0,0
Marc Pouliot,6,273,88,148,3,236,7,192,21,36,2,57,0,0,0,0,0,0
Nathan Dempsey,6,355,57,150,3,207,7,246,20,66,0,86,0,0,0,0,0,0
Patrick Traverse,7,418,43,132,6,175,6,274,14,51,2,65,0,0,0,0,0,0
Peter White,7,474,140,331,2,471,6,158,13,25,1,38,0,0,0,0,0,0
Pierre Parenteau,6,374,149,213,3,362,7,347,81,146,1,227,0,0,0,0,0,0
Raitis Ivanans,6,160,5,10,40,15,7,282,12,6,58,18,0,0,0,0,0,0
Scott Ferguson,6,399,30,118,35,148,7,218,7,14,28,21,0,0,0,0,0,0
Trevor Lewis,6,201,42,54,1,96,7,349,27,46,2,73,0,0,0,0,0,0
Willie Mitchell,3,110,9,30,8,39,14,861,33,140,27,173,0,0,0,0,0,0
Andrew Gordon,8,502,167,197,6,364,5,55,3,4,0,7,0,0,0,0,0,0
Andrew Hutchinson,8,396,65,163,1,228,5,140,12,27,0,39,0,0,0,0,0,0
Ben Walter,8,566,159,301,2,460,5,24,1,0,0,1,0,0,0,0,0,0
Brad Richardson,4,73,19,42,0,61,10,509,62,87,9,149,0,0,0,0,0,0
Brandon Smith,10,623,86,293,1,379,4,33,3,4,0,7,0,0,0,0,0,0
Byron Ritchie,5,226,68,109,14,177,8,324,25,33,22,58,0,0,0,0,0,0
Chris Mueller,8,447,131,155,8,286,5,53,3,7,0,10,0,0,0,0,0,0
Dylan Reese,8,398,31,130,12,161,5,78,3,14,2,17,0,0,0,0,0,0
Francis Wathier,10,577,96,114,73,210,4,10,0,0,1,0,0,0,0,0,0,0
Glen Metropolit,5,197,74,152,2,226,8,407,57,102,2,159,0,0,0,0,0,0
Gordie Dwyer,8,153,14,19,41,33,5,108,0,5,46,5,0,0,0,0,0,0
Greg Zanon,5,233,14,68,2,82,8,493,12,50,1,62,0,0,0,0,0,0
Jack Skille,5,211,76,84,7,160,8,239,30,31,9,61,0,0,0,0,0,0
Jiri Tlusty,5,130,50,70,0,120,8,416,87,86,0,173,0,0,0,0,0,0
John Slaney,8,481,122,279,1,401,5,135,6,32,1,38,0,0,0,0,0,0
Matt Lashoff,8,337,43,113,12,156,5,74,1,15,0,16,0,0,0,0,0,0
Micheal Haley,8,437,75,70,114,145,5,56,2,1,22,3,0,0,0,0,0,0
Paul Healey,8,441,173,155,2,328,5,75,6,14,0,20,0,0,0,0,0,0
Pierre Dagenais,8,384,153,124,3,277,5,142,35,23,0,58,0,0,0,0,0,0
Randy Robitaille,4,156,55,120,0,175,10,530,84,172,1,256,0,0,0,0,0,0
Rich Brennan,8,411,66,192,8,258,5,48,2,6,1,8,0,0,0,0,0,0
Rocky Thompson,10,573,15,60,148,75,4,25,0,0,14,0,0,0,0,0,0,0
Ryan Bayda,8,299,87,143,4,230,5,179,16,24,1,40,0,0,0,0,0,0
Ryan Parent,8,239,4,24,3,28,5,106,1,6,0,7,0,0,0,0,0,0
Stephen Gionta,8,374,63,83,4,146,5,188,14,25,0,39,0,0,0,0,0,0
Steve Bernier,4,85,27,34,2,61,10,609,104,120,12,224,0,0,0,0,0,0
Steve Eminger,4,140,8,27,1,35,10,488,19,80,3,99,0,0,0,0,0,0
Andy Sutton,3,31,5,11,4,16,13,676,38,112,55,150,0,0,0,0,0,0
Brad Lukowich,3,163,11,60,1,71,13,658,23,90,7,113,0,0,0,0,0,0
Mikael Samuelsson,3,76,35,52,1,87,13,699,149,197,5,346,0,0,0,0,0,0
Ales Kotalik,4,109,24,45,0,69,9,542,136,148,3,284,0,0,0,0,0,0
Benoit Pouliot,4,146,39,48,3,87,9,429,95,99,5,194,0,0,0,0,0,0
Brian Pothier,4,179,20,93,2,113,9,362,26,92,3,118,0,0,0,0,0,0
Bruno St. Jacques,9,368,25,99,9,124,4,67,3,7,1,10,0,0,0,0,0,0
Colin Stuart,9,533,128,122,4,250,4,56,8,5,0,13,0,0,0,0,0,0
Colin White,3,205,10,46,21,56,12,797,21,108,37,129,0,0,0,0,0,0
Craig Darby,6,452,141,286,0,427,6,164,20,27,0,47,0,0,0,0,0,0
Dave Steckel,4,285,61,84,4,145,9,425,33,46,5,79,0,0,0,0,0,0
David Oliver,6,172,48,53,6,101,6,78,10,13,0,23,0,0,0,0,0,0
Dennis Seidenberg,3,71,17,24,3,41,12,697,38,174,4,212,0,0,0,0,0,0
Derrick Walser,9,439,96,195,0,291,4,91,8,21,0,29,0,0,0,0,0,0
Dmitri Kalinin,4,80,2,20,2,22,9,539,36,126,4,162,0,0,0,0,0,0
Domenic Pittis,6,339,120,254,7,374,6,85,5,11,1,16,0,0,0,0,0,0
Dustin Jeffrey,6,272,81,147,1,228,6,124,17,14,0,31,0,0,0,0,0,0
Eric Cairns,4,48,2,5,11,7,9,417,10,31,89,41,0,0,0,0,0,0
Eric Manlow,9,556,134,287,0,421,4,37,2,4,0,6,0,0,0,0,0,0
Eric Nystrom,4,109,21,21,3,42,9,547,68,48,42,116,0,0,0,0,0,0
Graham Mink,12,727,257,252,35,509,3,7,0,0,0,0,0,0,0,0,0,0
Jason Botterill,6,326,127,106,27,233,6,88,5,9,5,14,0,0,0,0,0,0
Jeff Toms,6,207,95,114,0,209,6,201,20,25,1,45,0,0,0,0,0,0
Josh Langfeld,6,298,97,98,2,195,6,143,9,23,0,32,0,0,0,0,0,0
Mark Hartigan,6,334,137,173,5,310,6,102,19,11,0,30,0,0,0,0,0,0
Marty Murray,6,295,78,190,1,268,6,244,28,39,1,67,0,0,0,0,0,0
Mathieu Biron,6,289,27,69,5,96,6,253,12,32,1,44,0,0,0,0,0,0
Mike Cammalleri,3,67,30,48,0,78,12,737,263,281,3,544,0,0,0,0,0,0
Patrick Sharp,3,141,43,52,3,95,12,745,249,277,9,526,0,0,0,0,0,0
Peter Ferraro,9,476,176,266,10,442,4,85,9,14,0,23,0,0,0,0,0,0
Peter Harrold,4,185,20,85,0,105,9,274,13,29,0,42,0,0,0,0,0,0
Peter Schaefer,4,163,36,82,2,118,9,572,99,162,2,261,0,0,0,0,0,0
Raffi Torres,3,179,56,54,7,110,12,635,137,123,24,260,0,0,0,0,0,0
Ruslan Fedotenko,3,88,20,34,0,54,12,863,173,193,9,366,0,0,0,0,0,0
Shane O'Brien,4,219,24,65,34,89,9,537,13,79,44,92,0,0,0,0,0,0
Steve Ott,3,83,18,22,14,40,12,774,106,173,117,279,0,0,0,0,0,0
Tim Kennedy,6,335,71,196,2,267,6,162,15,24,0,39,0,0,0,0,0,0
Aaron Gavey,5,295,70,137,5,207,7,230,25,35,11,60,0,0,0,0,0,0
Brantt Myhres,7,201,16,31,27,47,5,92,1,1,43,2,0,0,0,0,0,0
Brendan Bell,7,428,49,185,1,234,5,102,7,21,1,28,0,0,0,0,0,0
Cameron Mann,7,361,144,180,17,324,5,93,14,10,3,24,0,0,0,0,0,0
Christian Laflamme,5,108,3,30,1,33,7,320,2,44,2,46,0,0,0,0,0,0
Clay Wilson,7,487,89,233,5,322,5,36,4,4,0,8,0,0,0,0,0,0
Dale Purinton,7,250,11,22,85,33,5,181,4,16,55,20,0,0,0,0,0,0
Derek Joslin,7,272,30,85,4,115,5,116,4,12,4,16,0,0,0,0,0,0
Jamie McGinn,5,116,36,39,5,75,7,366,69,59,10,128,0,0,0,0,0,0
Jim McKenzie,5,93,7,10,5,17,7,455,22,31,95,53,0,0,0,0,0,0
Joe Motzko,7,347,128,165,2,293,5,25,4,2,0,6,0,0,0,0,0,0
Lee Goren,7,434,165,201,49,366,5,67,5,4,6,9,0,0,0,0,0,0
Matt Hendricks,5,232,67,85,21,152,7,411,40,41,70,81,0,0,0,0,0,0
Mike Keane,5,365,36,78,6,114,7,519,58,96,8,154,0,0,0,0,0,0
P.J. Stock,5,239,32,65,71,97,7,235,5,21,56,26,0,0,0,0,0,0
Pat Dwyer,5,296,80,90,6,170,7,416,42,51,1,93,0,0,0,0,0,0
Reid Simpson,5,101,19,25,29,44,7,240,17,9,78,26,0,0,0,0,0,0
Taylor Chorney,7,400,31,111,5,142,5,68,1,6,0,7,0,0,0,0,0,0
Tim Brent,5,256,82,123,7,205,7,207,21,27,2,48,0,0,0,0,0,0
Tim Wallace,7,375,93,86,20,179,5,101,4,9,3,13,0,0,0,0,0,0
Tomas Kloucek,7,312,10,42,24,52,5,141,2,8,9,10,0,0,0,0,0,0
Vladimir Chebaturkin,7,382,19,49,17,68,5,62,2,7,0,9,0,0,0,0,0,0
Daniel Cleary,2,97,31,70,3,101,17,938,165,222,9,387,0,0,0,0,0,0
Matt Cullen,2,21,16,14,0,30,17,1212,219,407,3,626,0,0,0,0,0,0
Zdeno Chara,2,71,6,11,12,17,17,1195,169,369,70,538,0,0,0,0,0,0
Antoine Vermette,3,163,68,56,0,124,11,834,194,239,1,433,0,0,0,0,0,0
Brad Boyes,3,238,91,109,6,200,11,762,203,278,3,481,0,0,0,0,0,0
Chad Wiseman,11,620,171,279,8,450,3,9,1,1,0,2,0,0,0,0,0,0
Dan Jancevski,11,839,37,198,46,235,3,9,0,0,0,0,0,0,0,0,0,0
Dan Smith,11,720,26,109,27,135,3,22,0,0,2,0,0,0,0,0,0,0
Dave Scatchard,3,88,28,24,3,52,11,659,128,141,55,269,0,0,0,0,0,0
John-Michael Liles,3,26,3,12,0,15,11,719,81,263,2,344,0,0,0,0,0,0
Matt Bradley,3,181,50,47,14,97,11,675,59,90,77,149,0,0,0,0,0,0
Nick Boynton,3,146,11,46,8,57,11,605,34,110,46,144,0,0,0,0,0,0
Richard Park,3,144,62,78,1,140,11,669,97,131,1,228,0,0,0,0,0,0
Ryan Malone,3,30,4,8,1,12,11,647,179,191,45,370,0,0,0,0,0,0
Zbynek Michalek,3,179,13,36,1,49,11,711,40,131,0,171,0,0,0,0,0,0
Allan Rourke,8,462,57,123,5,180,4,55,1,4,1,5,0,0,0,0,0,0
Antti Laaksonen,4,168,47,54,0,101,8,483,81,87,0,168,0,0,0,0,0,0
Ben Simon,8,497,82,117,9,199,4,81,3,1,3,4,0,0,0,0,0,0
Brad Smyth,8,546,259,282,26,541,4,29,5,4,1,9,0,0,0,0,0,0
Bruno Gervais,4,187,30,49,0,79,8,418,16,71,4,87,0,0,0,0,0,0
Bryan Bickell,4,228,51,58,15,109,8,359,65,68,12,133,0,0,0,0,0,0
Bryan Rodney,8,414,39,176,0,215,4,34,1,12,0,13,0,0,0,0,0,0
Cal O'Reilly,8,416,74,297,1,371,4,113,13,28,0,41,0,0,0,0,0,0
Chris Bourque,8,504,170,327,1,497,4,51,2,6,0,8,0,0,0,0,0,0
Chris Ferraro,8,397,131,208,4,339,4,60,5,8,1,13,0,0,0,0,0,0
Daniel Corso,8,348,91,169,1,260,4,77,14,11,0,25,0,0,0,0,0,0
David Ling,8,374,91,217,31,308,4,91,4,4,24,8,0,0,0,0,0,0
Deron Quint,4,37,8,26,0,34,8,385,38,73,0,111,0,0,0,0,0,0
Fernando Pisani,4,213,72,77,0,149,8,462,87,82,2,169,0,0,0,0,0,0
Igor Ulanov,4,26,3,6,0,9,8,437,18,75,11,93,0,0,0,0,0,0
Jiri Bicek,8,447,79,177,2,256,4,62,6,7,0,13,0,0,0,0,0,0
Joe Hulbig,8,368,96,111,13,207,4,49,4,4,1,8,0,0,0,0,0,0
Joe Piskula,8,533,13,101,13,114,4,13,0,0,0,0,0,0,0,0,0,0
Matt Cooke,2,55,20,26,2,46,16,1046,167,231,36,398,0,0,0,0,0,0
Mike Van Ryn,4,149,9,39,1,48,8,353,30,99,0,129,0,0,0,0,0,0
Norm Milley,8,544,153,219,4,372,4,29,2,4,0,6,0,0,0,0,0,0
Patrick Boileau,8,411,47,135,9,182,4,47,5,11,0,16,0,0,0,0,0,0
Rostislav Olesz,4,73,26,41,0,67,8,365,57,77,0,134,0,0,0,0,0,0
Ryan VandenBussche,4,60,6,3,19,9,8,299,9,10,88,19,0,0,0,0,0,0
T.J. Hensick,8,438,130,301,2,431,4,112,12,26,0,38,0,0,0,0,0,0
Alexei Semenov,5,158,13,17,8,30,6,211,7,26,15,33,0,0,0,0,0,0
Andrei Zyuzin,3,43,6,18,0,24,10,496,38,82,3,120,0,0,0,0,0,0
Andrew Murray,5,244,52,48,5,100,6,221,24,16,0,40,0,0,0,0,0,0
Andrew Peters,5,232,10,5,82,15,6,229,4,3,84,7,0,0,0,0,0,0
Andy Wozniewski,6,213,23,76,1,99,5,79,2,10,1,12,0,0,0,0,0,0
Anthony Stewart,5,225,44,56,17,100,6,262,27,44,9,71,0,0,0,0,0,0
Benn Ferriero,6,271,73,106,1,179,5,98,14,9,1,23,0,0,0,0,0,0
Brad Brown,5,194,4,15,46,19,6,322,2,27,61,29,0,0,0,0,0,0
Brad Isbister,3,56,24,16,4,40,10,541,106,116,29,222,0,0,0,0,0,0
Brad Norton,6,263,10,53,29,63,5,124,3,8,27,11,0,0,0,0,0,0
Brad Staubitz,6,291,9,31,71,40,5,230,10,11,59,21,0,0,0,0,0,0
Chad Kilger,3,44,19,16,1,35,10,616,96,98,4,194,0,0,0,0,0,0
Chris McAlpine,5,37,5,15,0,20,6,250,6,21,2,27,0,0,0,0,0,0
Chris Summers,6,230,6,29,4,35,5,67,2,7,3,9,0,0,0,0,0,0
Chris Thorburn,3,138,29,44,13,73,10,604,43,68,86,111,0,0,0,0,0,0
Chris Vande Velde,6,236,38,48,4,86,5,118,10,9,0,19,0,0,0,0,0,0
Dallas Eakins,6,286,14,52,3,66,5,63,0,5,7,5,0,0,0,0,0,0
Darroll Powe,5,211,33,39,18,72,6,329,28,28,10,56,0,0,0,0,0,0
David Desharnais,5,183,62,122,0,184,6,339,64,147,0,211,0,0,0,0,0,0
Denis Gauthier,3,162,7,38,5,45,10,554,17,60,33,77,0,0,0,0,0,0
Eric Tangradi,5,226,74,78,14,152,6,143,5,10,7,15,0,0,0,0,0,0
Hnat Domenichelli,5,235,122,109,2,231,6,244,49,58,2,107,0,0,0,0,0,0
Ivan Ciernik,6,214,50,58,0,108,5,89,12,14,0,26,0,0,0,0,0,0
Jakub Kindl,5,237,13,76,3,89,6,248,14,48,1,62,0,0,0,0,0,0
James Wisniewski,3,73,10,35,3,45,10,551,53,221,20,274,0,0,0,0,0,0
Jeff Hamilton,6,299,130,125,1,255,5,157,32,45,0,77,0,0,0,0,0,0
Jeff Tambellini,5,175,101,100,0,201,6,242,27,36,1,63,0,0,0,0,0,0
Jordan Hendry,6,263,13,37,11,50,5,131,4,9,0,13,0,0,0,0,0,0
Josh Hennessy,6,438,142,175,0,317,5,23,1,0,0,1,0,0,0,0,0,0
Juraj Kolnik,5,266,87,100,1,187,6,240,46,49,0,95,0,0,0,0,0,0
Ken Sutton,6,318,31,127,8,158,5,106,2,11,2,13,0,0,0,0,0,0
Kevin Bieksa,3,28,3,20,5,23,10,597,56,185,44,241,0,0,0,0,0,0
Kevin Klein,3,155,15,50,4,65,10,498,26,88,11,114,0,0,0,0,0,0
Kevin Porter,5,272,79,116,7,195,6,206,29,26,1,55,0,0,0,0,0,0
Kevyn Adams,3,161,38,67,7,105,10,540,59,77,14,136,0,0,0,0,0,0
Kyle Quincey,3,201,16,59,9,75,10,448,26,103,5,129,0,0,0,0,0,0
Ladislav Kohn,5,230,76,125,7,201,6,181,13,28,7,41,0,0,0,0,0,0
Marc Chouinard,5,192,38,36,1,74,6,320,37,41,3,78,0,0,0,0,0,0
Mark Cullen,10,570,165,285,0,450,3,38,7,10,0,17,0,0,0,0,0,0
Maxim Lapierre,3,129,31,43,6,74,10,614,65,74,24,139,0,0,0,0,0,0
Mike Watt,6,255,59,77,4,136,5,157,15,26,1,41,0,0,0,0,0,0
Nathan McIver,10,508,10,28,148,38,3,36,0,1,16,1,0,0,0,0,0,0
Nick Johnson,6,234,71,94,7,165,5,113,14,23,4,37,0,0,0,0,0,0
Paul Bissonnette,5,217,14,23,72,37,6,202,7,15,53,22,0,0,0,0,0,0
Rod Pelley,6,355,57,56,9,113,5,256,9,20,11,29,0,0,0,0,0,0
Ryan Jones,5,53,19,11,4,30,6,334,54,46,7,100,0,0,0,0,0,0
Steve Guolla,6,241,115,182,2,297,5,162,27,38,3,65,0,0,0,0,0,0
Steve Halko,5,292,14,75,7,89,6,155,0,15,3,15,0,0,0,0,0,0
Sylvain Blouin,6,268,37,46,60,83,5,109,3,4,30,7,0,0,0,0,0,0
Theo Peckham,5,192,12,33,27,45,6,160,4,13,20,17,0,0,0,0,0,0
Zac Dalpe,6,230,84,85,2,169,5,117,10,10,0,20,0,0,0,0,0,0
Andre Savage,7,403,129,192,0,321,4,66,10,14,0,24,0,0,0,0,0,0
Andrei Markov,2,26,4,11,0,15,14,846,108,384,1,492,0,0,0,0,0,0
Andrew MacDonald,4,114,13,33,0,46,7,372,19,86,3,105,0,0,0,0,0,0
Aris Brimanis,7,258,25,67,2,92,4,92,2,9,1,11,0,0,0,0,0,0
Ben Lovejoy,4,218,18,62,5,80,7,268,11,57,7,68,0,0,0,0,0,0
Bill Lindsay,4,73,15,31,4,46,7,424,38,68,37,106,0,0,0,0,0,0
Branislav Mezei,4,81,1,12,5,13,7,240,5,19,5,24,0,0,0,0,0,0
Brett Lebda,4,115,8,48,2,56,7,397,20,56,1,76,0,0,0,0,0,0
Brett Sterling,7,440,224,199,3,423,4,30,5,4,0,9,0,0,0,0,0,0
Chris Stewart,4,103,31,27,14,58,7,463,129,135,43,264,0,0,0,0,0,0
Craig Adams,2,34,9,6,4,15,14,951,55,105,61,160,0,0,0,0,0,0
David Hale,4,72,5,11,3,16,7,327,4,25,14,29,0,0,0,0,0,0
Drake Berehowsky,4,29,2,1,2,3,7,420,31,86,27,117,0,0,0,0,0,0
Dwayne Hay,7,331,63,97,6,160,4,79,2,4,0,6,0,0,0,0,0,0
Eric Landry,7,432,169,207,7,376,4,68,5,9,1,14,0,0,0,0,0,0
Eric Meloche,7,413,92,123,11,215,4,74,9,11,0,20,0,0,0,0,0,0
Filip Kuba,2,122,6,21,1,27,14,836,70,263,1,333,0,0,0,0,0,0
Guillaume Lefebvre,7,430,64,75,54,139,4,39,2,4,1,6,0,0,0,0,0,0
Jamal Mayers,2,81,28,31,10,59,14,909,90,128,127,218,0,0,0,0,0,0
Jay Beagle,4,211,47,48,6,95,7,254,23,24,1,47,0,0,0,0,0,0
Jay Pandolfo,2,63,20,23,0,43,14,853,94,118,2,212,0,0,0,0,0,0
Joe DiPenta,7,507,12,59,34,71,4,174,6,17,6,23,0,0,0,0,0,0
Josh Gratton,7,223,32,40,70,72,4,86,3,3,33,6,0,0,0,0,0,0
Lauri Korpikoski,4,166,40,57,2,97,7,469,68,91,0,159,0,0,0,0,0,0
Lukas Krajicek,4,75,5,20,0,25,7,328,11,61,1,72,0,0,0,0,0,0
Marc Moro,7,486,12,52,44,64,4,30,0,0,7,0,0,0,0,0,0,0
Mark Mowers,4,217,95,120,0,215,7,278,18,44,0,62,0,0,0,0,0,0
Martin Grenier,7,432,18,43,120,61,4,18,1,0,2,1,0,0,0,0,0,0
Matt Beleskey,4,103,25,42,6,67,7,329,57,55,25,112,0,0,0,0,0,0
Matt D'Agostini,4,162,58,70,0,128,7,324,52,55,5,107,0,0,0,0,0,0
Matt Halischuk,4,118,38,39,0,77,7,250,33,39,1,72,0,0,0,0,0,0
Matt Herr,7,460,164,170,5,334,4,58,4,5,1,9,0,0,0,0,0,0
Matt Higgins,7,289,54,102,1,156,4,57,1,2,0,3,0,0,0,0,0,0
Mike Santorelli,4,214,76,100,0,176,7,336,55,65,0,120,0,0,0,0,0,0
Richard Jackman,4,28,6,14,0,20,7,231,19,58,2,77,0,0,0,0,0,0
Serge Payer,7,384,63,123,14,186,4,124,7,6,6,13,0,0,0,0,0,0
Shawn Horcoff,2,26,11,20,1,31,14,949,180,316,8,496,0,0,0,0,0,0
Ted Donato,4,88,37,58,0,95,7,424,54,81,0,135,0,0,0,0,0,0
Tomas Kaberle,2,4,0,2,0,2,14,984,87,476,1,563,0,0,0,0,0,0
Travis Roche,7,397,64,193,2,257,4,60,6,14,0,20,0,0,0,0,0,0
Ville Nieminen,4,243,69,82,5,151,7,385,48,69,2,117,0,0,0,0,0,0
Yannick Weber,4,155,33,62,0,95,7,229,22,41,0,63,0,0,0,0,0,0
Brad Mills,9,347,58,76,43,134,3,34,1,1,4,2,0,0,0,0,0,0
Brad Tiley,9,624,81,262,5,343,3,11,0,0,0,0,0,0,0,0,0,0
Curtis Glencross,3,108,42,37,13,79,9,507,134,141,11,275,0,0,0,0,0,0
Dan Hinote,3,144,33,51,8,84,9,503,38,52,30,90,0,0,0,0,0,0
David Booth,3,30,8,8,2,16,9,502,120,111,5,231,0,0,0,0,0,0
Doug Murray,3,97,13,20,5,33,9,518,7,57,30,64,0,0,0,0,0,0
Erik Rasmussen,3,116,23,31,4,54,9,545,52,76,3,128,0,0,0,0,0,0
Garrett Stafford,9,598,87,257,4,344,3,7,0,2,0,2,0,0,0,0,0,0
George Parros,3,75,3,8,20,11,9,474,18,18,165,36,0,0,0,0,0,0
Guillaume Desbiens,9,451,71,85,90,156,3,23,0,0,7,0,0,0,0,0,0,0
Joe Callahan,9,499,18,101,12,119,3,46,0,4,0,4,0,0,0,0,0,0
Loui Eriksson,3,95,37,34,0,71,9,643,182,259,0,441,0,0,0,0,0,0
Marc Methot,3,195,10,32,3,42,9,442,16,80,7,96,0,0,0,0,0,0
Matthew Lombardi,3,153,50,42,0,92,9,536,101,161,1,262,0,0,0,0,0,0
Mike Angelidis,9,579,119,126,106,245,3,10,1,0,3,1,0,0,0,0,0,0
Mike York,3,123,27,76,0,103,9,579,127,195,1,322,0,0,0,0,0,0
Niklas Grossman,3,138,4,11,1,15,9,531,10,69,4,79,0,0,0,0,0,0
Patrick Kaleta,3,94,7,16,16,23,9,348,27,27,40,54,0,0,0,0,0,0
Ryan Flinn,9,330,16,20,121,36,3,31,1,0,12,1,0,0,0,0,0,0
Ryan Whitney,3,55,12,26,0,38,9,481,50,209,7,259,0,0,0,0,0,0
Travis Brigley,9,525,131,178,1,309,3,55,3,6,0,9,0,0,0,0,0,0
John Madden,2,149,58,96,2,154,13,898,165,183,1,348,0,0,0,0,0,0
Marc Savard,2,67,24,63,0,87,13,807,207,499,7,706,0,0,0,0,0,0
Nik Antropov,2,36,11,24,0,35,13,788,193,272,5,465,0,0,0,0,0,0
Sheldon Souray,2,46,4,15,5,19,13,758,109,191,55,300,0,0,0,0,0,0
Stephen Weiss,2,13,8,3,0,11,13,732,156,267,3,423,0,0,0,0,0,0
Todd White,2,41,22,26,0,48,13,653,141,240,0,381,0,0,0,0,0,0
Wade Belak,2,40,0,3,10,3,13,544,8,25,129,33,0,0,0,0,0,0
Wade Redden,2,119,12,50,3,62,13,941,103,324,23,427,0,0,0,0,0,0
Brandon Bochenski,5,180,102,99,1,201,5,156,28,40,0,68,0,0,0,0,0,0
Derek Smith,5,304,40,126,2,166,5,94,2,12,0,14,0,0,0,0,0,0
Harold Druken,5,175,64,85,1,149,5,146,27,35,0,62,0,0,0,0,0,0
Jeremy Morin,5,208,81,77,12,158,5,82,10,12,3,22,0,0,0,0,0,0
Louie DeBrusk,5,84,6,5,9,11,5,173,5,5,46,10,0,0,0,0,0,0
Luke Adam,5,283,93,110,1,203,5,90,15,11,0,26,0,0,0,0,0,0
Marc-Andre Gragnani,5,325,50,184,3,234,5,74,3,15,0,18,0,0,0,0,0,0
Marco Scandella,5,96,7,35,3,42,5,229,18,37,3,55,0,0,0,0,0,0
Mark Popovic,5,358,38,103,3,141,5,81,2,5,0,7,0,0,0,0,0,0
Noah Welch,5,208,19,58,7,77,5,75,4,5,2,9,0,0,0,0,0,0
Patrice Cormier,5,210,48,48,27,96,5,50,1,4,2,5,0,0,0,0,0,0
Paul Byron,5,224,58,82,7,140,5,138,17,31,1,48,0,0,0,0,0,0
Reed Low,5,252,25,34,80,59,5,256,3,16,82,19,0,0,0,0,0,0
Sami Helenius,5,91,1,3,16,4,5,152,2,3,25,5,0,0,0,0,0,0
Todd Reirden,5,254,34,72,0,106,5,183,11,35,5,46,0,0,0,0,0,0
Yan Stastny,5,239,65,82,12,147,5,91,6,10,4,16,0,0,0,0,0,0
Aaron Palushaj,6,258,76,118,1,194,4,68,3,11,1,14,0,0,0,0,0,0
Aaron Voros,6,203,40,37,28,77,4,162,18,19,42,37,0,0,0,0,0,0
Alexander Sulzer,4,155,24,79,1,103,6,131,7,15,0,22,0,0,0,0,0,0
Alexandre Daigle,4,112,30,79,0,109,6,353,62,109,1,171,0,0,0,0,0,0
Andre Deveaux,8,448,98,108,59,206,3,31,0,2,13,2,0,0,0,0,0,0
Andy McDonald,2,67,22,50,0,72,12,685,182,307,0,489,0,0,0,0,0,0
Bob Sanguinetti,8,338,50,160,0,210,3,45,2,4,0,6,0,0,0,0,0,0
Bobby Ryan,3,70,33,44,3,77,8,526,188,203,7,391,0,0,0,0,0,0
Bracken Kearns,8,517,116,174,53,290,3,31,3,2,2,5,0,0,0,0,0,0
Brandon Prust,3,221,39,51,75,90,8,451,39,69,123,108,0,0,0,0,0,0
Brian Boyle,3,114,41,42,8,83,8,473,67,57,18,124,0,0,0,0,0,0
Chad LaRose,3,122,39,38,0,77,8,508,85,95,5,180,0,0,0,0,0,0
Chris Chelios,2,48,5,18,0,23,12,731,32,196,12,228,0,0,0,0,0,0
Chris O'Sullivan,6,256,43,156,1,199,4,35,0,9,1,9,0,0,0,0,0,0
Corey Locke,8,561,166,359,0,525,3,9,0,1,0,1,0,0,0,0,0,0
Dan Focht,8,388,12,49,38,61,3,82,2,6,10,8,0,0,0,0,0,0
Daniel Winnik,3,78,10,13,0,23,8,569,58,126,12,184,0,0,0,0,0,0
Darryl Bootland,8,320,69,70,76,139,3,32,1,2,12,3,0,0,0,0,0,0
Dave Karpa,4,119,3,26,2,29,6,312,7,35,24,42,0,0,0,0,0,0
Dave Roche,8,515,146,136,41,282,3,39,3,3,3,6,0,0,0,0,0,0
Derek Bekar,8,490,159,131,5,290,3,11,0,0,0,0,0,0,0,0,0,0
Doug Houda,6,413,32,124,9,156,4,61,2,5,5,7,0,0,0,0,0,0
Drew Miller,3,163,55,55,1,110,8,488,56,57,4,113,0,0,0,0,0,0
Duvie Westcott,4,149,10,72,7,82,6,201,11,45,5,56,0,0,0,0,0,0
Eric Chouinard,6,249,70,87,0,157,4,90,11,11,0,22,0,0,0,0,0,0
Georges Laraque,2,71,16,28,21,44,12,695,53,100,138,153,0,0,0,0,0,0
Henrik Tallinder,2,77,6,15,0,21,12,678,28,114,0,142,0,0,0,0,0,0
J.P. Dumont,2,63,39,24,1,63,12,822,214,309,0,523,0,0,0,0,0,0
Jamie Allison,3,68,2,10,9,12,8,351,7,23,47,30,0,0,0,0,0,0
Jamie Pushor,3,140,8,32,20,40,8,441,10,38,45,48,0,0,0,0,0,0
Jamie Wright,4,184,60,73,4,133,6,124,12,20,2,32,0,0,0,0,0,0
Jason Dawe,6,293,82,122,0,204,4,144,26,28,0,54,0,0,0,0,0,0
Jason Spezza,2,86,44,64,2,108,12,768,268,481,5,749,0,0,0,0,0,0
Jerome Samson,8,450,161,183,3,344,3,46,2,7,0,9,0,0,0,0,0,0
Jesse Joensuu,4,177,42,69,6,111,6,129,13,11,1,24,0,0,0,0,0,0
Joakim Lindstrom,4,187,69,105,1,174,6,150,19,24,0,43,0,0,0,0,0,0
Joel Rechlicz,8,207,4,3,84,7,3,26,0,1,11,1,0,0,0,0,0,0
Joel Ward,3,209,38,48,2,86,8,517,97,123,1,220,0,0,0,0,0,0
John McCarthy,6,302,68,91,7,159,4,87,3,3,0,6,0,0,0,0,0,0
John Zeiler,6,245,38,52,8,90,4,90,1,4,4,5,0,0,0,0,0,0
Jonathan Ericsson,3,176,17,61,8,78,8,407,17,66,10,83,0,0,0,0,0,0
Jordan Leopold,2,6,2,4,0,6,12,695,67,147,1,214,0,0,0,0,0,0
Mark Bell,3,174,40,60,8,100,8,450,87,95,38,182,0,0,0,0,0,0
Mark Greig,6,421,170,276,3,446,4,30,5,7,0,12,0,0,0,0,0,0
Mark Letestu,4,191,51,83,1,134,6,318,58,69,1,127,0,0,0,0,0,0
Mark Wotton,12,783,71,232,3,303,2,6,0,0,0,0,0,0,0,0,0,0
Matt Davidson,8,513,126,129,0,255,3,56,5,7,0,12,0,0,0,0,0,0
Matt Hunwick,3,110,12,45,2,57,8,347,18,60,2,78,0,0,0,0,0,0
Matt Moulson,3,188,74,86,4,160,8,474,154,162,0,316,0,0,0,0,0,0
Matt Pelech,8,425,18,36,92,54,3,13,1,3,4,4,0,0,0,0,0,0
Matt Smaby,6,212,7,36,5,43,4,122,0,6,4,6,0,0,0,0,0,0
Matt Stajan,2,2,0,2,0,2,12,774,130,231,4,361,0,0,0,0,0,0
Matt Taormina,6,308,42,117,1,159,4,56,4,8,0,12,0,0,0,0,0,0
Michel Ouellet,6,207,69,85,1,154,4,190,52,64,0,116,0,0,0,0,0,0
Mike Glumac,8,420,154,152,21,306,3,40,7,6,4,13,0,0,0,0,0,0
Mike Kostka,8,406,42,172,4,214,3,70,4,16,1,20,0,0,0,0,0,0
Nathan Perrott,6,265,33,47,88,80,4,89,4,5,34,9,0,0,0,0,0,0
Niko Dimitrakos,6,264,79,109,1,188,4,158,24,38,2,62,0,0,0,0,0,0
Noah Clarke,6,256,79,108,4,187,4,21,3,1,0,4,0,0,0,0,0,0
Pascal Trepanier,4,246,50,93,4,143,6,229,12,22,4,34,0,0,0,0,0,0
Pat Maroon,6,353,118,160,32,278,4,148,22,44,25,66,0,0,0,0,0,0
Patrick O'Sullivan,4,198,99,124,0,223,6,334,58,103,0,161,0,0,0,0,0,0
Philippe Dupuis,6,308,73,91,0,164,4,116,6,12,1,18,0,0,0,0,0,0
Pierre-Cedric Labrie,8,448,61,80,75,141,3,46,2,3,9,5,0,0,0,0,0,0
Radek Martinek,2,6,0,6,0,6,12,486,25,85,1,110,0,0,0,0,0,0
Ramzi Abid,6,269,107,121,29,228,4,68,14,16,5,30,0,0,0,0,0,0
Ray Giroux,6,386,71,173,5,244,4,38,0,13,0,13,0,0,0,0,0,0
Rich Clune,8,337,32,60,127,92,3,106,7,9,29,16,0,0,0,0,0,0
Rich Peverley,3,176,56,112,3,168,8,442,84,157,3,241,0,0,0,0,0,0
Richard Petiot,8,338,19,73,11,92,3,15,0,3,1,3,0,0,0,0,0,0
Rob Valicevic,4,264,56,101,0,157,6,193,28,20,1,48,0,0,0,0,0,0
Simon Gamache,6,302,118,142,5,260,4,48,6,7,0,13,0,0,0,0,0,0
Staffan Kronwall,6,193,21,79,2,100,4,66,1,3,1,4,0,0,0,0,0,0
Steve Downie,3,49,14,36,13,50,8,408,73,117,55,190,0,0,0,0,0,0
Steve Dubinsky,4,78,28,31,0,59,6,284,21,36,1,57,0,0,0,0,0,0
Steve Pinizzotto,8,310,51,95,38,146,3,36,2,4,8,6,0,0,0,0,0,0
Steve Poapst,4,225,12,72,0,84,6,304,7,28,0,35,0,0,0,0,0,0
Tanner Glass,3,91,10,15,19,25,8,443,19,41,63,60,0,0,0,0,0,0
Tavis Hansen,8,491,142,127,24,269,3,32,2,1,2,3,0,0,0,0,0,0
Tony Tuzzolino,8,364,60,95,17,155,3,9,0,0,1,0,0,0,0,0,0,0
Travis Morin,8,413,121,238,0,359,3,13,0,1,0,1,0,0,0,0,0,0
Tyler Kennedy,3,53,19,30,0,49,8,477,86,113,16,199,0,0,0,0,0,0
Chris Higgins,2,74,21,27,0,48,11,678,162,167,0,329,0,0,0,0,0,0
Chris Kunitz,2,64,19,29,2,48,11,733,224,287,12,511,0,0,0,0,0,0
Darren McCarty,2,32,10,11,4,21,11,529,79,92,78,171,0,0,0,0,0,0
Derek Roy,2,34,17,29,1,46,11,738,189,335,1,524,0,0,0,0,0,0
Greg Campbell,2,87,16,19,7,35,11,721,68,108,63,176,0,0,0,0,0,0
Maxime Fortunus,11,685,64,178,3,242,2,9,0,1,0,1,0,0,0,0,0,0
Michael Nylander,2,31,6,18,0,24,11,709,168,367,0,535,0,0,0,0,0,0
Niklas Kronwall,2,26,2,11,0,13,11,674,71,268,0,339,0,0,0,0,0,0
Samuel Pahlsson,2,26,2,14,0,16,11,798,68,131,0,199,0,0,0,0,0,0
Anton Babchuk,3,111,15,30,0,45,7,289,36,71,0,107,0,0,0,0,0,0
Bob Wren,7,460,159,293,13,452,3,5,0,0,0,0,0,0,0,0,0,0
Boris Valabik,7,211,6,31,42,37,3,80,0,7,13,7,0,0,0,0,0,0
Chris Minard,7,370,159,113,4,272,3,40,2,4,1,6,0,0,0,0,0,0
Chris Murray,7,135,13,23,13,36,3,127,8,11,24,19,0,0,0,0,0,0
Chris Terry,7,380,121,180,3,301,3,70,12,11,0,23,0,0,0,0,0,0
Dan Bylsma,3,40,4,6,3,10,7,346,16,37,10,53,0,0,0,0,0,0
Danny Richmond,7,417,30,123,69,153,3,49,0,3,9,3,0,0,0,0,0,0
Darrel Scoville,7,370,50,130,6,180,3,16,0,1,0,1,0,0,0,0,0,0
Darryl Boyce,7,276,48,82,24,130,3,84,6,12,3,18,0,0,0,0,0,0
Freddy Meyer,3,78,17,19,0,36,7,281,20,53,3,73,0,0,0,0,0,0
Greg Classen,7,393,97,135,5,232,3,90,7,10,0,17,0,0,0,0,0,0
Greg Mauldin,7,398,111,129,5,240,3,36,5,5,0,10,0,0,0,0,0,0
Igor Korolev,3,38,9,10,0,19,7,489,76,136,0,212,0,0,0,0,0,0
J.T. Wyman,7,387,67,90,1,157,3,44,2,9,0,11,0,0,0,0,0,0
Jamie Heward,3,106,26,66,1,92,7,369,37,82,3,119,0,0,0,0,0,0
Jason King,7,343,123,117,1,240,3,59,12,11,1,23,0,0,0,0,0,0
Jean-Francois Fortin,7,180,18,36,2,54,3,71,1,4,0,5,0,0,0,0,0,0
Jim Montgomery,7,429,145,297,1,442,3,37,1,8,1,9,0,0,0,0,0,0
John Scott,3,173,6,8,29,14,7,274,5,5,37,10,0,0,0,0,0,0
Josef Boumedienne,7,365,43,180,7,223,3,47,4,12,1,16,0,0,0,0,0,0
Kip Miller,3,186,65,122,1,187,7,368,61,143,0,204,0,0,0,0,0,0
Kyle Turris,3,86,28,43,0,71,7,398,93,133,3,226,0,0,0,0,0,0
Kyle Wilson,7,427,149,171,3,320,3,39,4,9,0,13,0,0,0,0,0,0
Matt Jones,7,218,13,27,2,40,3,106,1,10,1,11,0,0,0,0,0,0
Mattias Timander,3,109,7,35,1,42,7,378,12,49,1,61,0,0,0,0,0,0
Max Pacioretty,3,82,25,47,2,72,7,399,144,136,6,280,0,0,0,0,0,0
Michael Ryan,7,260,97,93,6,190,3,83,7,8,0,15,0,0,0,0,0,0
Mike Peluso,7,409,140,157,8,297,3,61,4,2,10,6,0,0,0,0,0,0
Mike Weber,3,181,7,36,14,43,7,306,8,40,25,48,0,0,0,0,0,0
Nathan Oystrick,7,338,64,142,25,206,3,65,5,10,7,15,0,0,0,0,0,0
Pat Kavanagh,7,412,98,102,17,200,3,14,2,0,0,2,0,0,0,0,0,0
Robert Dome,7,299,119,141,6,260,3,53,7,7,0,14,0,0,0,0,0,0
Scott Barney,7,333,109,75,9,184,3,27,5,6,0,11,0,0,0,0,0,0
Serge Aubin,3,182,80,92,1,172,7,374,44,64,5,108,0,0,0,0,0,0
Steve Webb,3,97,12,24,26,36,7,280,4,9,39,13,0,0,0,0,0,0
Stu Bickel,7,221,9,32,40,41,3,76,0,10,19,10,0,0,0,0,0,0
Tim Conboy,7,404,14,52,82,66,3,59,0,6,16,6,0,0,0,0,0,0
Torrey Mitchell,3,18,4,7,1,11,7,457,42,63,5,105,0,0,0,0,0,0
Tyler Arnason,3,78,27,33,2,60,7,487,88,157,0,245,0,0,0,0,0,0
Tyson Nash,3,202,50,61,14,111,7,374,27,37,33,64,0,0,0,0,0,0
Vladimir Sobotka,3,68,34,40,5,74,7,381,35,88,7,123,0,0,0,0,0,0
Alex Burrows,2,35,12,18,1,30,10,688,175,167,30,342,0,0,0,0,0,0
Andre Benoit,5,319,43,130,5,173,4,179,11,37,0,48,0,0,0,0,0,0
Andreas Nodl,4,113,22,38,0,60,5,183,15,21,0,36,0,0,0,0,0,0
Andrei Loktionov,4,132,29,68,0,97,5,155,22,26,0,48,0,0,0,0,0,0
Barry Tallackson,5,311,76,88,5,164,4,20,1,1,0,2,0,0,0,0,0,0
Bert Robertsson,5,126,13,20,9,33,4,123,4,10,5,14,0,0,0,0,0,0
Bobby Butler,4,221,87,79,3,166,5,130,20,29,1,49,0,0,0,0,0,0
Brad Chartrand,4,174,48,70,1,118,5,215,25,25,5,50,0,0,0,0,0,0
Brandon Pirri,4,238,68,132,0,200,5,105,35,16,0,51,0,0,0,0,0,0
Brian Strait,4,220,8,32,3,40,5,130,5,16,0,21,0,0,0,0,0,0
Brian Swanson,5,257,84,142,0,226,4,70,4,13,0,17,0,0,0,0,0,0
Carl Klingberg,5,269,66,78,3,144,4,12,1,0,0,1,0,0,0,0,0,0
Casey Wellman,5,300,96,130,2,226,4,54,6,10,0,16,0,0,0,0,0,0
Cody Goloubef,5,201,18,52,4,70,4,53,1,9,1,10,0,0,0,0,0,0
Cory Emmerton,5,270,50,107,0,157,4,139,12,9,0,21,0,0,0,0,0,0
Daniel Paille,2,74,21,27,1,48,10,570,85,87,2,172,0,0,0,0,0,0
David Harlock,4,224,9,64,0,73,5,204,2,14,1,16,0,0,0,0,0,0
Davis Drewiske,4,149,5,34,1,39,5,135,5,20,1,25,0,0,0,0,0,0
Denis Shvidki,5,227,48,90,0,138,4,76,11,14,0,25,0,0,0,0,0,0
Gabriel Dumont,5,318,73,81,28,154,4,18,1,2,1,3,0,0,0,0,0,0
Harry Zolnierczyk,5,233,58,67,9,125,4,59,5,4,4,9,0,0,0,0,0,0
Herbert Vasiljevs,5,321,96,150,0,246,4,51,8,7,0,15,0,0,0,0,0,0
Ian Cole,4,109,10,28,2,38,5,187,10,29,5,39,0,0,0,0,0,0
Ivan Novoseltsev,4,87,18,34,0,52,5,234,31,44,3,75,0,0,0,0,0,0
Jarrod Skalde,5,236,65,133,4,198,4,67,6,10,3,16,0,0,0,0,0,0
Jay McClement,2,79,16,18,0,34,10,764,82,143,5,225,0,0,0,0,0,0
Jeff Finger,5,231,11,51,9,62,4,199,17,40,8,57,0,0,0,0,0,0
Jeff Jillson,5,268,29,84,1,113,4,140,9,32,6,41,0,0,0,0,0,0
Jim Dowd,2,86,23,59,1,82,10,632,60,139,4,199,0,0,0,0,0,0
Jim Fahey,5,175,7,67,10,74,4,92,1,24,5,25,0,0,0,0,0,0
Jim Slater,2,7,1,1,0,2,10,584,67,71,20,138,0,0,0,0,0,0
Jiri Hudler,2,133,53,92,0,145,10,604,145,226,0,371,0,0,0,0,0,0
Joe Colborne,4,211,50,75,4,125,5,160,19,43,1,62,0,0,0,0,0,0
Joe Murphy,5,309,72,83,5,155,4,182,47,56,6,103,0,0,0,0,0,0
John Pohl,5,306,124,159,2,283,4,115,17,21,1,38,0,0,0,0,0,0
Jon DiSalvatore,10,713,213,310,3,523,2,6,0,0,0,0,0,0,0,0,0,0
Jonathan Girard,4,104,9,53,0,62,5,150,10,34,2,44,0,0,0,0,0,0
Jordan Caron,4,134,36,42,2,78,5,153,12,16,4,28,0,0,0,0,0,0
Kevin Westgarth,4,224,22,28,66,50,5,169,7,9,32,16,0,0,0,0,0,0
Kyle Palmieri,4,148,75,59,4,134,5,198,43,46,3,89,0,0,0,0,0,0
Mark Rycroft,5,291,56,97,9,153,4,226,21,25,6,46,0,0,0,0,0,0
Mark Stuart,2,109,8,19,6,27,10,567,23,63,42,86,0,0,0,0,0,0
Matt Greene,2,26,2,5,1,7,10,586,16,62,44,78,0,0,0,0,0,0
Maxim Kuznetsov,5,204,10,26,2,36,4,136,2,8,4,10,0,0,0,0,0,0
Nicklas Bergfors,4,257,64,86,0,150,5,173,35,48,0,83,0,0,0,0,0,0
Patrick Eaves,2,25,9,10,0,19,10,491,88,85,5,173,0,0,0,0,0,0
Petr Svoboda,4,118,10,19,0,29,5,222,12,61,5,73,0,0,0,0,0,0
Rene Bourque,2,5,2,2,0,4,10,611,148,142,6,290,0,0,0,0,0,0
Rob Schremp,4,217,47,125,0,172,5,114,20,34,0,54,0,0,0,0,0,0
Ryane Clowe,2,106,24,48,11,72,10,491,112,197,57,309,0,0,0,0,0,0
Shane Hnidy,2,136,18,39,17,57,10,550,16,55,40,71,0,0,0,0,0,0
Slava Voynov,5,266,42,81,3,123,4,190,18,63,1,81,0,0,0,0,0,0
Stacy Roest,4,222,82,155,0,237,5,244,28,48,0,76,0,0,0,0,0,0
Terry Virtue,10,632,48,222,43,270,2,5,0,0,0,0,0,0,0,0,0,0
Thomas Pock,4,207,33,106,2,139,5,118,8,9,0,17,0,0,0,0,0,0
Tom Pyatt,4,156,32,51,0,83,5,245,27,27,1,54,0,0,0,0,0,0
Tomas Malec,5,289,11,67,11,78,4,46,0,2,3,2,0,0,0,0,0,0
Valtteri Filppula,2,77,22,52,0,74,10,640,137,220,0,357,0,0,0,0,0,0
Yuri Butsayev,5,142,63,48,0,111,4,99,10,4,0,14,0,0,0,0,0,0
Yves Sarault,4,105,30,45,2,75,5,45,6,7,3,13,0,0,0,0,0,0
Adam Burish,2,118,21,19,10,40,9,378,27,33,30,60,0,0,0,0,0,0
Adam McQuaid,3,178,8,26,27,34,6,283,9,34,42,43,0,0,0,0,0,0
Alec Martinez,3,147,20,49,1,69,6,259,29,48,0,77,0,0,0,0,0,0
Alyn McCauley,2,52,17,29,0,46,9,488,69,97,0,166,0,0,0,0,0,0
Andrej Sekera,2,94,5,31,0,36,9,486,31,128,0,159,0,0,0,0,0,0
Billy Tibbetts,6,192,61,93,44,154,3,82,2,8,16,10,0,0,0,0,0,0
Bobby Allen,6,326,22,77,0,99,3,51,0,3,0,3,0,0,0,0,0,0
Brandon Mashinter,6,398,96,98,57,194,3,23,0,0,5,0,0,0,0,0,0,0
Brett Bellemore,6,300,6,34,22,40,3,121,4,16,5,20,0,0,0,0,0,0
Brian Lashoff,6,194,12,30,3,42,3,117,2,11,1,13,0,0,0,0,0,0
Casey Hankinson,6,447,128,144,21,272,3,18,0,1,1,1,0,0,0,0,0,0
Christian Backman,3,148,17,40,0,57,6,302,23,56,0,79,0,0,0,0,0,0
Dan Girardi,2,111,10,53,1,63,9,651,40,158,5,198,0,0,0,0,0,0
Darius Kasparaitis,2,16,1,3,0,4,9,574,19,80,14,99,0,0,0,0,0,0
Darren Rumble,6,223,21,104,1,125,3,36,0,4,0,4,0,0,0,0,0,0
Dave Liffiton,6,306,15,46,66,61,3,7,1,0,2,1,0,0,0,0,0,0
David Backes,2,43,15,8,3,23,9,648,185,230,30,415,0,0,0,0,0,0
David Clarkson,2,123,33,39,35,72,9,547,112,84,96,196,0,0,0,0,0,0
David Krejci,2,94,38,64,1,102,9,551,117,292,4,409,0,0,0,0,0,0
David Moss,2,91,30,39,0,69,9,501,78,100,2,178,0,0,0,0,0,0
Denis Grebeshkov,3,129,5,39,0,44,6,234,17,68,0,85,0,0,0,0,0,0
Erik Reitz,6,387,39,119,38,158,3,48,1,1,8,2,0,0,0,0,0,0
Erik Westrum,6,410,104,189,11,293,3,27,1,2,0,3,0,0,0,0,0,0
Evan Oberg,6,331,30,86,2,116,3,7,0,0,0,0,0,0,0,0,0,0
Frank Banham,6,336,100,99,3,199,3,29,9,2,0,11,0,0,0,0,0,0
Frans Nielsen,2,102,30,52,1,82,9,525,99,198,0,297,0,0,0,0,0,0
Grant Clitsome,3,169,14,40,1,54,6,205,15,56,1,71,0,0,0,0,0,0
Greg Rallo,9,529,138,148,5,286,2,11,1,0,0,1,0,0,0,0,0,0
Ian Moran,2,30,2,5,2,7,9,402,16,44,7,60,0,0,0,0,0,0
J.P. Vigier,3,188,83,70,0,153,6,213,23,23,1,46,0,0,0,0,0,0
James Sheppard,3,40,8,16,0,24,6,394,23,68,10,91,0,0,0,0,0,0
Jamie McBain,3,83,9,36,0,45,6,301,28,73,0,101,0,0,0,0,0,0
Jan Bulis,2,7,1,6,0,7,9,552,96,149,0,245,0,0,0,0,0,0
Jean-Guy Trudel,6,464,175,304,0,479,3,5,0,0,0,0,0,0,0,0,0,0
Jean-Philippe Cote,9,572,21,92,55,113,2,27,0,4,2,4,0,0,0,0,0,0
Jordan Schroeder,6,227,57,86,0,143,3,81,9,14,0,23,0,0,0,0,0,0
Justin Papineau,6,257,119,119,3,238,3,81,11,8,0,19,0,0,0,0,0,0
Karel Pilar,6,127,21,56,0,77,3,90,6,24,0,30,0,0,0,0,0,0
Kaspars Daugavins,6,189,48,64,2,112,3,91,6,9,1,15,0,0,0,0,0,0
Keith Yandle,2,99,7,42,2,49,9,579,67,255,6,322,0,0,0,0,0,0
Ladislav Smid,2,79,4,29,1,33,9,561,12,60,15,72,0,0,0,0,0,0
Marc-Andre Cliche,6,341,68,83,9,151,3,151,3,11,2,14,0,0,0,0,0,0
Marcus Nilson,2,133,17,48,2,65,9,521,67,101,13,168,0,0,0,0,0,0
Mark Giordano,2,78,16,44,3,60,9,510,66,179,13,245,0,0,0,0,0,0
Mathieu Perreault,3,167,38,97,2,135,6,290,69,85,0,154,0,0,0,0,0,0
Matt Hussey,6,370,70,90,0,160,3,21,2,2,0,4,0,0,0,0,0,0
Mike Farrell,6,332,54,65,17,119,3,13,0,0,0,0,0,0,0,0,0,0
Mikhail Grabovski,2,78,25,49,0,74,9,476,116,155,2,271,0,0,0,0,0,0
Nazem Kadri,3,119,43,64,5,107,6,250,64,88,3,152,0,0,0,0,0,0
Nick Spaling,3,131,20,34,1,54,6,379,49,62,0,111,0,0,0,0,0,0
Pascal Pelletier,6,426,139,206,11,345,3,16,0,0,0,0,0,0,0,0,0,0
Paul Szczechura,6,271,82,111,4,193,3,92,10,10,0,20,0,0,0,0,0,0
Radoslav Suchy,3,112,10,48,0,58,6,451,13,58,0,71,0,0,0,0,0,0
Raymond Sawada,6,287,47,79,35,126,3,11,1,0,0,1,0,0,0,0,0,0
Robbie Earl,6,313,66,103,1,169,3,47,6,1,0,7,0,0,0,0,0,0
Ryan Callahan,2,71,42,28,3,70,9,547,162,157,13,319,0,0,0,0,0,0
Ryan O'Byrne,3,118,3,23,9,26,6,308,5,34,15,39,0,0,0,0,0,0
Ryan O'Marra,6,286,30,54,11,84,3,33,1,6,1,7,0,0,0,0,0,0
Ryan Wilson,3,72,4,18,8,22,6,230,7,60,13,67,0,0,0,0,0,0
Sean Gagnon,6,264,21,44,40,65,3,12,0,1,5,1,0,0,0,0,0,0
Sean Pronger,3,180,53,59,4,112,6,214,16,28,5,44,0,0,0,0,0,0
Sergei Kostitsyn,3,54,15,33,0,48,6,353,67,109,3,176,0,0,0,0,0,0
Shawn Heins,3,145,25,73,15,98,6,125,4,12,13,16,0,0,0,0,0,0
Steve Kampfer,6,218,24,69,3,93,3,86,9,10,0,19,0,0,0,0,0,0
T.J. Brennan,6,374,88,163,16,251,3,46,4,8,1,12,0,0,0,0,0,0
Todd Gill,3,50,2,17,0,19,6,289,23,41,7,64,0,0,0,0,0,0
Tony Hrkac,3,97,22,44,0,66,6,425,70,105,1,175,0,0,0,0,0,0
Trevor Letowski,2,142,43,55,0,98,9,616,84,117,1,201,0,0,0,0,0,0
Olli Jokinen,1,9,3,6,0,9,17,1231,321,429,26,750,0,0,0,0,0,0
Patrik Elias,1,3,3,0,0,3,17,1206,404,608,6,1012,0,0,0,0,0,0
Shane Doan,1,39,21,21,4,42,17,1257,357,512,36,869,0,0,0,0,0,0
Akim Aliu,8,231,43,28,11,71,2,7,2,1,0,3,0,0,0,0,0,0
Alex Goligoski,2,96,12,44,0,56,8,480,50,190,0,240,0,0,0,0,0,0
"Andrew ""Bubba"" Berenzweig",4,192,30,52,0,82,4,37,3,7,0,10,0,0,0,0,0,0
Anton Lander,4,136,37,71,0,108,4,132,8,20,0,28,0,0,0,0,0,0
Anton Stralman,2,57,7,20,0,27,8,476,27,124,1,151,0,0,0,0,0,0
B.J. Crombeen,2,117,19,21,30,40,8,445,34,46,101,80,0,0,0,0,0,0
Brandon Bollig,4,146,13,11,44,24,4,187,8,11,28,19,0,0,0,0,0,0
Cal Clutterbuck,2,75,11,13,3,24,8,495,81,64,10,145,0,0,0,0,0,0
Carl Corazzini,8,492,126,144,0,270,2,19,2,1,0,3,0,0,0,0,0,0
Chris Dingman,2,94,14,18,25,32,8,385,15,19,101,34,0,0,0,0,0,0
Chris Hajt,8,495,28,80,7,108,2,6,0,0,0,0,0,0,0,0,0,0
Christian Matte,4,276,129,177,1,306,4,20,1,2,0,3,0,0,0,0,0,0
Claude Giroux,2,38,18,18,0,36,8,496,144,306,4,450,0,0,0,0,0,0
Cory Cross,2,4,0,0,0,0,8,464,27,73,7,100,0,0,0,0,0,0
D.J. Smith,8,389,37,93,68,130,2,37,1,0,8,1,0,0,0,0,0,0
Dan McGillis,2,108,17,49,1,66,8,561,50,166,2,216,0,0,0,0,0,0
Dan Trebil,4,150,20,58,8,78,4,56,1,1,1,2,0,0,0,0,0,0
Dave Gove,8,451,100,127,2,227,2,2,0,1,0,1,0,0,0,0,0,0
David Cullen,8,526,53,194,1,247,2,19,0,0,0,0,0,0,0,0,0,0
David Legwand,1,3,0,0,0,0,16,1057,223,381,0,604,0,0,0,0,0,0
Derek Morris,1,3,1,2,0,3,16,1107,92,332,35,424,0,0,0,0,0,0
Drew Bannister,4,204,20,64,8,84,4,86,1,10,3,11,0,0,0,0,0,0
Eric Weinrich,2,88,3,19,1,22,8,637,31,154,5,185,0,0,0,0,0,0
Erik Gustafsson,4,144,13,82,1,95,4,91,6,17,0,23,0,0,0,0,0,0
Grant Marshall,2,125,13,48,3,61,8,572,77,123,57,200,0,0,0,0,0,0
Gustav Nyquist,4,137,53,90,0,143,4,179,59,56,0,115,0,0,0,0,0,0
Hal Gill,1,4,1,0,1,1,16,1108,36,148,31,184,0,0,0,0,0,0
Jack Hillen,2,35,4,15,1,19,8,304,13,58,1,71,0,0,0,0,0,0
Jake Muzzin,4,146,12,49,1,61,4,208,22,60,1,82,0,0,0,0,0,0
Jani Rita,4,268,84,95,1,179,4,66,9,5,0,14,0,0,0,0,0,0
Jared Ross,8,448,101,204,5,305,2,13,0,0,0,0,0,0,0,0,0,0
Jaroslav Obsut,8,332,37,97,1,134,2,7,0,0,0,0,0,0,0,0,0,0
Jason Marshall,2,50,7,12,5,19,8,426,14,41,37,55,0,0,0,0,0,0
Jason York,2,8,6,4,0,10,8,569,33,137,3,170,0,0,0,0,0,0
Jimmy Hayes,4,120,36,40,2,76,4,168,36,30,4,66,0,0,0,0,0,0
Jiri Novotny,4,200,22,69,0,91,4,189,20,31,0,51,0,0,0,0,0,0
Joakim Andersson,4,189,38,63,1,101,4,176,14,19,0,33,0,0,0,0,0,0
John Tripp,8,258,79,77,20,156,2,43,2,7,5,9,0,0,0,0,0,0
Jon Matsumoto,8,486,145,180,2,325,2,14,2,0,0,2,0,0,0,0,0,0
Justin Abdelkader,2,109,35,41,12,76,8,398,61,71,16,132,0,0,0,0,0,0
Karl Stewart,4,277,66,71,15,137,4,69,2,4,2,6,0,0,0,0,0,0
Krzysztof Oliwa,2,30,0,2,4,2,8,409,17,28,177,45,0,0,0,0,0,0
Ladislav Nagy,2,89,29,42,1,71,8,435,115,196,1,311,0,0,0,0,0,0
Liam Reddox,4,186,57,64,0,121,4,100,6,18,0,24,0,0,0,0,0,0
Mariusz Czerkawski,2,40,16,24,0,40,8,548,158,161,2,319,0,0,0,0,0,0
Mark Borowiecki,4,185,11,33,37,44,4,84,2,10,17,12,0,0,0,0,0,0
Mark Flood,8,391,56,121,5,177,2,39,3,5,0,8,0,0,0,0,0,0
Mason Raymond,2,31,9,12,0,21,8,513,111,135,0,246,0,0,0,0,0,0
Mattias Ritola,4,228,50,83,0,133,4,43,4,5,0,9,0,0,0,0,0,0
Mattias Tedenby,4,126,28,38,0,66,4,120,10,20,0,30,0,0,0,0,0,0
Mattias Weinhandl,4,104,39,57,0,96,4,182,19,37,0,56,0,0,0,0,0,0
Maxim Mayorov,4,260,63,56,0,119,4,22,2,1,0,3,0,0,0,0,0,0
Michel Picard,4,303,112,180,0,292,4,70,13,23,1,36,0,0,0,0,0,0
Mike LeClerc,2,113,43,50,11,93,8,336,63,93,19,156,0,0,0,0,0,0
Niklas Hjalmarsson,2,99,6,25,1,31,8,469,16,85,1,101,0,0,0,0,0,0
Oleg Tverdovsky,2,23,13,14,0,27,8,513,57,163,2,220,0,0,0,0,0,0
Pavel Rosa,4,200,95,119,0,214,4,36,5,13,0,18,0,0,0,0,0,0
Peter Holland,4,143,55,69,7,124,4,130,21,21,1,42,0,0,0,0,0,0
Robert Bortuzzo,4,236,10,43,23,53,4,126,5,17,16,22,0,0,0,0,0,0
Sean Brown,2,64,5,12,11,17,8,431,14,43,68,57,0,0,0,0,0,0
Shawn Matthias,2,88,16,17,0,33,8,408,69,62,4,131,0,0,0,0,0,0
Steve Washburn,4,136,39,82,0,121,4,74,11,8,0,19,0,0,0,0,0,0
Ted Purcell,2,105,41,80,0,121,8,483,87,175,0,262,0,0,0,0,0,0
Tim Stapleton,4,176,67,95,0,162,4,118,19,18,0,37,0,0,0,0,0,0
Todd Bertuzzi,1,2,0,0,0,0,16,1019,286,422,33,708,0,0,0,0,0,0
Tomas Tatar,4,265,87,109,6,196,4,182,53,50,0,103,0,0,0,0,0,0
Tommy Albelin,2,10,0,4,0,4,8,407,11,65,0,76,0,0,0,0,0,0
Yannick Tremblay,2,62,15,27,0,42,8,385,38,87,3,125,0,0,0,0,0,0
Aaron Volpatti,3,66,3,10,13,13,5,114,5,2,18,7,0,0,0,0,0,0
Adam Henrique,3,92,30,29,0,59,5,269,68,85,2,153,0,0,0,0,0,0
Alex Tanguay,1,5,1,2,0,3,15,1018,275,553,2,828,0,0,0,0,0,0
Andreas Karlsson,3,98,30,54,0,84,5,264,16,35,0,51,0,0,0,0,0,0
Andrew Desjardins,3,212,39,58,19,97,5,285,15,35,26,50,0,0,0,0,0,0
Arturs Kulda,5,260,18,60,10,78,3,15,0,2,0,2,0,0,0,0,0,0
Ben Smith,3,155,61,48,1,109,5,175,25,19,0,44,0,0,0,0,0,0
Ben Street,5,278,91,125,0,216,3,22,0,2,0,2,0,0,0,0,0,0
Brad Tapper,5,160,45,61,1,106,3,71,14,11,2,25,0,0,0,0,0,0
Brandon Reid,5,332,88,147,1,235,3,13,2,4,0,6,0,0,0,0,0,0
Brandon Yip,3,103,19,29,1,48,5,174,29,27,7,56,0,0,0,0,0,0
Casey Borer,5,210,13,39,5,52,3,16,1,2,1,3,0,0,0,0,0,0
Chris Tanev,3,102,3,32,0,35,5,226,10,37,0,47,0,0,0,0,0,0
Christian Hanson,5,278,52,79,8,131,3,42,3,6,0,9,0,0,0,0,0,0
Christoph Schubert,3,210,6,26,2,32,5,315,25,47,2,72,0,0,0,0,0,0
Cory Murphy,5,76,8,43,0,51,3,91,9,27,0,36,0,0,0,0,0,0
Dan Fritsche,3,90,20,33,0,53,5,256,34,42,3,76,0,0,0,0,0,0
Dmitri Afanasenkov,3,128,13,25,0,38,5,227,27,27,0,54,0,0,0,0,0,0
Dmitri Orlov,5,79,12,35,0,47,3,119,6,25,0,31,0,0,0,0,0,0
Drew Larman,5,268,50,50,5,100,3,26,2,1,0,3,0,0,0,0,0,0
Dylan Olsen,5,168,8,27,3,35,3,116,5,16,0,21,0,0,0,0,0,0
Eric Beaudoin,5,235,68,94,7,162,3,53,3,8,1,11,0,0,0,0,0,0
Fedor Fedorov,5,216,49,61,3,110,3,18,0,2,0,2,0,0,0,0,0,0
Ivan Huml,5,277,76,73,2,149,3,49,6,12,0,18,0,0,0,0,0,0
Jacob Josefson,3,60,15,25,0,40,5,180,13,23,0,36,0,0,0,0,0,0
Jan Mursak,5,213,43,60,4,103,3,46,2,2,0,4,0,0,0,0,0,0
Jason Jaspers,5,332,78,112,2,190,3,9,0,1,0,1,0,0,0,0,0,0
Jeff Petry,3,51,7,21,0,28,5,314,20,61,1,81,0,0,0,0,0,0
Joe Vitale,3,139,17,49,5,66,5,233,11,33,9,44,0,0,0,0,0,0
Joel Prpic,5,372,66,115,13,181,3,18,0,3,0,3,0,0,0,0,0,0
John Moore,3,102,9,26,1,35,5,230,9,31,4,40,0,0,0,0,0,0
Justin Braun,3,43,5,24,0,29,5,287,9,60,1,69,0,0,0,0,0,0
Kevin Brown,5,233,89,134,11,223,3,23,4,2,0,6,0,0,0,0,0,0
Kevin Dallman,5,217,15,65,2,80,3,154,8,23,1,31,0,0,0,0,0,0
Korbinian Holzer,5,267,10,59,8,69,3,58,2,7,2,9,0,0,0,0,0,0
Lane MacDermid,5,274,18,30,65,48,3,21,2,2,6,4,0,0,0,0,0,0
Lubos Bartecko,3,95,28,43,0,71,5,257,46,65,0,111,0,0,0,0,0,0
Luca Caputi,5,228,57,83,12,140,3,35,3,6,0,9,0,0,0,0,0,0
Magnus Paajarvi,3,108,22,52,0,74,5,228,32,39,0,71,0,0,0,0,0,0
Mark Olver,5,180,48,74,6,122,3,74,10,12,1,22,0,0,0,0,0,0
Matt Bartkowski,3,175,11,58,5,69,5,131,0,24,2,24,0,0,0,0,0,0
Matt Frattin,3,103,49,34,0,83,5,135,17,18,2,35,0,0,0,0,0,0
Matt Gilroy,3,81,16,24,0,40,5,225,11,37,1,48,0,0,0,0,0,0
Matt Murley,5,346,96,174,12,270,3,62,2,7,2,9,0,0,0,0,0,0
Michal Handzus,1,69,27,36,0,63,15,1009,185,298,3,483,0,0,0,0,0,0
Mike Duco,5,267,56,51,36,107,3,18,0,2,5,2,0,0,0,0,0,0
Mike Hurlbut,5,288,44,123,4,167,3,5,0,0,0,0,0,0,0,0,0,0
Mike Knuble,1,1,0,1,0,1,15,1059,277,270,7,547,0,0,0,0,0,0
Nick Palmieri,5,212,49,46,3,95,3,87,13,12,0,25,0,0,0,0,0,0
Pat Leahy,5,271,68,87,3,155,3,50,4,4,1,8,0,0,0,0,0,0
Patrick Bordeleau,5,228,9,24,51,33,3,129,8,8,12,16,0,0,0,0,0,0
Petr Sykora,1,2,4,1,0,5,15,947,306,374,1,680,0,0,0,0,0,0
Petteri Nokelainen,3,85,11,17,2,28,5,245,20,21,5,41,0,0,0,0,0,0
Philip Larsen,3,73,6,33,0,39,5,125,8,23,0,31,0,0,0,0,0,0
Radim Bicanek,3,222,40,97,10,137,5,95,1,10,0,11,0,0,0,0,0,0
Ricard Persson,3,53,8,21,3,29,5,163,4,35,11,39,0,0,0,0,0,0
Robert Nilsson,3,102,28,68,0,96,5,252,37,81,0,118,0,0,0,0,0,0
Rumun Ndur,5,131,6,24,28,30,3,67,2,3,11,5,0,0,0,0,0,0
Ryan Spooner,5,150,39,97,0,136,3,56,8,21,0,29,0,0,0,0,0,0
Ryan Stoa,5,290,82,86,10,168,3,40,4,3,1,7,0,0,0,0,0,0
Sami Salo,1,3,2,0,0,2,15,878,99,240,0,339,0,0,0,0,0,0
Scott Parse,5,127,22,46,1,68,3,73,14,16,0,30,0,0,0,0,0,0
Steve Kariya,5,291,112,157,0,269,3,65,9,18,0,27,0,0,0,0,0,0
Steve Oleksy,5,220,7,47,34,54,3,62,3,16,8,19,0,0,0,0,0,0
T.J. Brodie,3,115,7,50,0,57,5,266,19,81,0,100,0,0,0,0,0,0
Tomas Surovy,5,197,90,74,1,164,3,126,27,32,1,59,0,0,0,0,0,0
Zdenek Kutlak,5,325,24,56,3,80,3,16,1,2,0,3,0,0,0,0,0,0
Andrei Kostitsyn,2,114,39,60,2,99,7,398,103,119,2,222,0,0,0,0,0,0
Andrew Brunette,1,43,21,46,1,67,14,1076,261,455,0,716,0,0,0,0,0,0
Andrew Campbell,7,454,16,73,12,89,2,36,0,1,0,1,0,0,0,0,0,0
Artem Anisimov,2,154,53,71,1,124,7,412,86,106,0,192,0,0,0,0,0,0
Brad Bombardir,2,6,0,0,0,0,7,356,8,46,1,54,0,0,0,0,0,0
Brendan Morrison,1,72,35,49,0,84,14,934,200,401,0,601,0,0,0,0,0,0
Brian Holzinger,2,56,12,40,0,52,7,404,61,103,2,164,0,0,0,0,0,0
Chris Butler,2,41,3,18,0,21,7,382,13,71,3,84,0,0,0,0,0,0
Chris Durno,7,419,113,110,22,223,2,43,4,4,3,8,0,0,0,0,0,0
Clarke Wilm,2,115,29,43,11,72,7,455,37,60,17,97,0,0,0,0,0,0
Darby Hendrickson,2,51,9,13,1,22,7,384,47,47,7,94,0,0,0,0,0,0
Dave Lowry,2,44,6,12,0,18,7,343,42,55,9,97,0,0,0,0,0,0
Donald Audette,2,22,10,10,0,20,7,401,120,144,3,264,0,0,0,0,0,0
Drew Fata,7,289,16,44,50,60,2,8,1,1,1,2,0,0,0,0,0,0
Erik Johnson,2,2,0,0,0,0,7,456,48,145,9,193,0,0,0,0,0,0
Frederic St. Denis,7,382,31,103,1,134,2,21,1,3,0,4,0,0,0,0,0,0
James Neal,2,67,22,20,1,42,7,480,184,168,8,352,0,0,0,0,0,0
Jason Garrison,2,113,11,43,1,54,7,388,42,96,3,138,0,0,0,0,0,0
Jeff Halpern,1,6,2,1,0,3,14,976,152,221,17,373,0,0,0,0,0,0
Jochen Hecht,1,74,21,35,0,56,14,833,186,277,7,463,0,0,0,0,0,0
Jody Hull,2,35,3,10,0,13,7,354,29,36,0,65,0,0,0,0,0,0
Karel Rachunek,2,12,0,4,0,4,7,371,22,118,3,140,0,0,0,0,0,0
Matt Corrente,7,293,18,55,55,73,2,34,0,6,6,6,0,0,0,0,0,0
Michal Grosek,2,60,22,37,4,59,7,394,60,110,10,170,0,0,0,0,0,0
Mike Vernace,7,438,27,125,12,152,2,22,0,1,0,1,0,0,0,0,0,0
Mikkel Boedker,2,100,23,49,0,72,7,383,67,107,0,174,0,0,0,0,0,0
Milan Jurcina,2,80,5,15,0,20,7,430,22,59,0,81,0,0,0,0,0,0
Nathan Gerbe,2,101,41,53,2,94,7,347,55,76,3,131,0,0,0,0,0,0
Pavel Kubina,1,55,4,8,4,12,14,970,110,276,19,386,0,0,0,0,0,0
Peter Ratchuk,7,480,66,136,1,202,2,32,1,1,0,2,0,0,0,0,0,0
Peter Regin,2,125,28,60,0,88,7,243,23,44,0,67,0,0,0,0,0,0
Peter Worrell,2,60,18,13,25,31,7,391,19,27,142,46,0,0,0,0,0,0
Sergei Zholtok,2,8,3,5,0,8,7,506,97,129,1,226,0,0,0,0,0,0
Steve McKenna,2,9,2,1,5,3,7,364,18,14,86,32,0,0,0,0,0,0
Todd Rohloff,7,339,10,57,6,67,2,75,0,6,0,6,0,0,0,0,0,0
Vladimir Orszagh,2,123,26,35,1,61,7,289,54,65,2,119,0,0,0,0,0,0
Yannick Lehoux,7,435,115,168,0,283,2,10,2,2,0,4,0,0,0,0,0,0
Brian Gionta,1,37,9,16,0,25,13,845,262,258,1,520,0,0,0,0,0,0
Dany Heatley,1,43,8,12,0,20,13,869,372,419,0,791,0,0,0,0,0,0
Jaroslav Spacek,1,14,4,8,1,12,13,880,82,273,6,355,0,0,0,0,0,0
Jason Blake,1,2,0,1,0,1,13,871,213,273,3,486,0,0,0,0,0,0
Jason Strudwick,1,39,3,1,11,4,13,673,13,42,103,55,0,0,0,0,0,0
Peter Vandermeer,13,615,61,65,221,126,1,2,0,0,0,0,0,0,0,0,0,0
Radim Vrbata,1,20,8,14,0,22,13,871,246,281,1,527,0,0,0,0,0,0
Rostislav Klesla,1,21,3,6,0,9,13,659,48,111,12,159,0,0,0,0,0,0
Ruslan Salei,1,6,3,6,0,9,13,887,45,158,13,203,0,0,0,0,0,0
Sergei Samsonov,1,2,1,0,0,1,13,888,235,336,1,571,0,0,0,0,0,0
Taylor Pyatt,1,27,6,4,1,10,13,859,140,140,12,280,0,0,0,0,0,0
Tom Poti,1,2,1,0,0,1,13,824,69,258,2,327,0,0,0,0,0,0
Adam Larsson,3,67,7,33,0,40,4,192,6,45,0,51,0,0,0,0,0,0
Alan Letang,4,277,11,79,2,90,3,14,0,0,0,0,0,0,0,0,0,0
Alexander Korolyuk,2,67,25,36,0,61,6,296,62,80,5,142,0,0,0,0,0,0
Alexei Tezikov,4,183,23,52,3,75,3,30,1,1,0,2,0,0,0,0,0,0
Andrej Nedorost,4,171,33,53,0,86,3,28,2,3,0,5,0,0,0,0,0,0
Andy Miele,4,280,88,161,7,249,3,15,0,2,1,2,0,0,0,0,0,0
Anthony Peluso,4,181,15,14,42,29,3,107,3,6,16,9,0,0,0,0,0,0
Ben Holmstrom,6,318,54,88,26,142,2,7,0,0,1,0,0,0,0,0,0,0
Blake Bellefeuille,6,343,46,74,1,120,2,5,0,1,0,1,0,0,0,0,0,0
Brad Malone,3,165,29,46,11,75,4,119,11,13,9,24,0,0,0,0,0,0
Brad Marchand,2,113,31,60,3,91,6,377,116,112,6,228,0,0,0,0,0,0
Brad May,1,17,5,5,3,10,12,652,64,79,95,143,0,0,0,0,0,0
Brendan Smith,3,152,27,59,11,86,4,195,10,37,8,47,0,0,0,0,0,0
Brendan Witt,1,27,2,4,1,6,12,798,20,91,66,111,0,0,0,0,0,0
Cam Atkinson,3,89,49,38,1,87,4,219,59,53,0,112,0,0,0,0,0,0
Cameron Schilling,4,210,13,37,5,50,3,6,0,0,0,0,0,0,0,0,0,0
Chris Herperger,3,53,15,18,1,33,4,169,18,25,3,43,0,0,0,0,0,0
Christian Thomas,4,185,42,44,1,86,3,21,1,0,1,1,0,0,0,0,0,0
Connor James,4,287,57,103,1,160,3,16,1,0,0,1,0,0,0,0,0,0
Cory Conacher,4,166,67,86,2,153,3,141,19,39,1,58,0,0,0,0,0,0
Craig Mills,6,394,55,82,65,137,2,27,0,3,2,3,0,0,0,0,0,0
Dalton Prout,3,117,5,19,8,24,4,145,3,18,17,21,0,0,0,0,0,0
Darren Van Impe,2,12,2,8,0,10,6,320,20,68,24,88,0,0,0,0,0,0
Darryl Laplante,4,224,56,40,2,96,3,35,0,6,0,6,0,0,0,0,0,0
David Rundblad,3,86,16,43,0,59,4,104,4,19,0,23,0,0,0,0,0,0
David Savard,3,176,20,77,1,97,4,187,18,43,1,61,0,0,0,0,0,0
Dean McAmmond,1,6,1,2,0,3,12,830,153,207,6,360,0,0,0,0,0,0
Devante Smith-Pelly,3,124,41,35,2,76,4,149,15,28,0,43,0,0,0,0,0,0
Donald Brashear,1,27,2,4,1,6,12,855,74,108,177,182,0,0,0,0,0,0
Doug Doull,6,294,41,42,110,83,2,37,0,1,22,1,0,0,0,0,0,0
Drew Shore,4,146,29,73,1,102,3,78,9,14,0,23,0,0,0,0,0,0
Enver Lisin,3,70,20,23,0,43,4,135,24,18,0,42,0,0,0,0,0,0
Eric Bertrand,6,369,116,167,32,283,2,15,0,0,0,0,0,0,0,0,0,0
Eric Gryba,4,183,14,25,18,39,3,165,4,25,7,29,0,0,0,0,0,0
Evan Brophey,6,432,70,100,13,170,2,4,0,0,0,0,0,0,0,0,0,0
Evgeny Korolev,4,200,10,38,9,48,3,42,1,4,0,5,0,0,0,0,0,0
Fabian Brunnstrom,4,126,28,47,2,75,3,104,19,22,0,41,0,0,0,0,0,0
Frank Corrado,4,101,13,23,2,36,3,28,2,0,0,2,0,0,0,0,0,0
Gabriel Bourque,3,118,27,37,2,64,4,220,30,44,0,74,0,0,0,0,0,0
Garry Valk,2,44,12,10,0,22,6,342,33,65,3,98,0,0,0,0,0,0
Greg Hawgood,4,285,54,162,5,216,3,97,7,22,0,29,0,0,0,0,0,0
Greg Moore,6,377,86,111,5,197,2,10,0,0,0,0,0,0,0,0,0,0
Greg Stewart,4,248,29,32,40,61,3,26,0,1,7,1,0,0,0,0,0,0
Jake Gardiner,3,57,10,26,0,36,4,246,21,68,1,89,0,0,0,0,0,0
Jamie Sifers,6,401,24,86,21,110,2,37,0,2,3,2,0,0,0,0,0,0
Janne Laukkanen,2,10,0,6,0,6,6,297,18,76,1,94,0,0,0,0,0,0
Jason Akeson,4,265,81,144,2,225,3,15,1,1,0,2,0,0,0,0,0,0
Jason Demers,2,103,6,44,2,50,6,361,21,99,5,120,0,0,0,0,0,0
Jason Podollan,4,274,122,107,10,229,3,12,0,1,1,1,0,0,0,0,0,0
Jay McKee,1,13,1,7,1,8,12,758,20,94,19,114,0,0,0,0,0,0
Jeff Farkas,4,274,76,126,0,202,3,11,0,2,0,2,0,0,0,0,0,0
Jeff Giuliano,6,251,26,52,0,78,2,101,3,10,0,13,0,0,0,0,0,0
Jeff Heerema,6,345,138,164,4,302,2,32,4,2,0,6,0,0,0,0,0,0
Jiri Fischer,2,25,2,8,0,10,6,305,11,49,10,60,0,0,0,0,0,0
Joe Finley,6,184,2,15,35,17,2,21,0,1,4,1,0,0,0,0,0,0
Joe Sacco,2,12,8,6,0,14,6,400,29,49,12,78,0,0,0,0,0,0
Jon Kalinski,6,265,36,53,3,89,2,22,1,4,0,5,0,0,0,0,0,0
Jordan Nolan,3,136,16,29,20,45,4,194,16,13,20,29,0,0,0,0,0,0
Jordie Benn,3,165,18,47,3,65,4,180,6,38,0,44,0,0,0,0,0,0
Josef Marha,3,126,25,82,0,107,4,151,21,30,0,51,0,0,0,0,0,0
Julien Brouillette,6,309,29,59,1,88,2,11,1,1,0,2,0,0,0,0,0,0
Junior Lessard,4,248,82,88,3,170,3,27,3,1,1,4,0,0,0,0,0,0
Kamil Kreps,3,117,28,45,0,73,4,232,18,42,1,60,0,0,0,0,0,0
Kamil Piros,4,231,51,73,0,124,3,28,4,4,0,8,0,0,0,0,0,0
Kent McDonell,6,376,87,132,35,219,2,32,1,2,2,3,0,0,0,0,0,0
Kevin Sawyer,3,167,14,34,63,48,4,100,3,3,45,6,0,0,0,0,0,0
Konstantin Koltsov,4,150,25,51,2,76,3,144,12,26,0,38,0,0,0,0,0,0
Kristian Kudroc,4,182,1,23,17,24,3,26,2,2,0,4,0,0,0,0,0,0
Kyle Greentree,6,347,131,137,8,268,2,4,0,0,0,0,0,0,0,0,0,0
Ladislav Benysek,3,131,2,22,1,24,4,161,3,12,0,15,0,0,0,0,0,0
Logan Couture,2,46,20,33,1,53,6,379,139,149,1,288,0,0,0,0,0,0
Mark Arcobello,4,188,60,91,0,151,3,119,21,28,0,49,0,0,0,0,0,0
Marquis Mathieu,4,216,38,39,6,77,3,16,0,2,0,2,0,0,0,0,0,0
Mat Clark,6,303,5,42,22,47,2,9,0,1,0,1,0,0,0,0,0,0
Mathias Tjarnqvist,3,95,33,26,1,59,4,173,13,19,0,32,0,0,0,0,0,0
Mathieu Schneider,1,8,3,2,0,5,12,812,139,330,2,469,0,0,0,0,0,0
Mats Lindgren,2,8,0,2,0,2,6,318,43,60,0,103,0,0,0,0,0,0
Matt Donovan,4,180,32,87,6,119,3,67,2,17,0,19,0,0,0,0,0,0
Matt Foy,4,168,53,63,14,116,3,56,6,7,2,13,0,0,0,0,0,0
Matt Irwin,4,181,22,66,0,88,3,153,16,34,1,50,0,0,0,0,0,0
Matt Martin,2,83,13,21,14,34,6,358,32,37,58,69,0,0,0,0,0,0
Mike Lundin,2,78,6,39,0,45,6,252,4,32,0,36,0,0,0,0,0,0
Miroslav Satan,1,10,3,6,0,9,12,912,320,342,3,662,0,0,0,0,0,0
Nate Prosser,2,96,8,23,3,31,6,189,5,23,7,28,0,0,0,0,0,0
Nick Bonino,2,69,18,49,0,67,6,264,48,73,0,121,0,0,0,0,0,0
Nicklas Jensen,4,139,35,22,1,57,3,24,3,3,0,6,0,0,0,0,0,0
Nikita Alexeev,4,121,19,20,0,39,3,159,20,17,0,37,0,0,0,0,0,0
Nikita Filatov,3,90,32,32,0,64,4,53,6,8,0,14,0,0,0,0,0,0
Patrick Davis,6,317,47,76,4,123,2,9,1,0,0,1,0,0,0,0,0,0
Patrick Wiercioch,3,156,18,39,1,57,4,159,12,45,1,57,0,0,0,0,0,0
Paul Mara,1,36,1,10,3,11,12,735,64,189,21,253,0,0,0,0,0,0
Paul Ranger,2,52,8,19,0,27,6,323,24,82,0,106,0,0,0,0,0,0
Peter Sarno,6,323,65,183,1,248,2,7,1,0,0,1,0,0,0,0,0,0
Peter Sejna,3,142,43,84,0,127,4,49,7,4,0,11,0,0,0,0,0,0
Peter Smrek,6,388,20,91,0,111,2,28,2,4,0,6,0,0,0,0,0,0
Petr Prucha,2,21,8,13,0,21,6,346,78,68,3,146,0,0,0,0,0,0
Richard Lintner,4,143,20,48,1,68,3,112,8,12,0,20,0,0,0,0,0,0
Richard Panik,4,133,44,50,8,94,3,151,19,20,2,39,0,0,0,0,0,0
Riley Nash,3,188,35,54,0,89,4,178,22,37,0,59,0,0,0,0,0,0
Riley Sheahan,3,110,25,31,1,56,4,123,22,38,0,60,0,0,0,0,0,0
Roman Lyashenko,3,200,57,95,0,152,4,139,14,9,0,23,0,0,0,0,0,0
Sheldon Keefe,4,149,57,55,0,112,3,125,12,12,2,24,0,0,0,0,0,0
Simon Despres,3,107,15,29,4,44,4,160,6,33,5,39,0,0,0,0,0,0
Stefan Ruzicka,4,166,51,74,2,125,3,55,4,13,1,17,0,0,0,0,0,0
Stephane Da Costa,3,159,44,88,0,132,4,47,7,4,0,11,0,0,0,0,0,0
Stephane Matteau,2,6,0,0,0,0,6,397,59,68,15,127,0,0,0,0,0,0
Steve Heinze,2,36,16,18,0,34,6,388,107,101,0,208,0,0,0,0,0,0
Steve Moore,4,197,34,47,0,81,3,69,5,7,1,12,0,0,0,0,0,0
Steve Zalewski,6,383,82,151,4,233,2,10,0,0,0,0,0,0,0,0,0,0
Taylor Beck,4,193,44,87,0,131,3,85,11,12,0,23,0,0,0,0,0,0
Teemu Laakso,4,217,17,55,1,72,3,17,0,0,0,0,0,0,0,0,0,0
Tim Erixon,3,132,13,87,0,100,4,93,2,12,0,14,0,0,0,0,0,0
Timo Helbling,6,301,13,50,12,63,2,11,0,1,0,1,0,0,0,0,0,0
Tom Cavanagh,6,286,59,109,2,168,2,18,1,2,0,3,0,0,0,0,0,0
Tom Preissing,2,63,11,26,0,37,6,326,31,101,2,132,0,0,0,0,0,0
Tomi Pettinen,4,250,3,30,0,33,3,24,0,0,0,0,0,0,0,0,0,0
Tommy Westlund,3,94,10,24,1,34,4,203,9,13,2,22,0,0,0,0,0,0
Tyler Eckford,6,336,29,83,5,112,2,7,0,1,0,1,0,0,0,0,0,0
Vaclav Nedorost,4,80,27,32,0,59,3,99,10,10,0,20,0,0,0,0,0,0
Viktor Stalberg,2,59,23,27,0,50,6,338,62,70,3,132,0,0,0,0,0,0
Vladimir Zharkov,4,185,41,72,2,113,3,82,2,12,0,14,0,0,0,0,0,0
Yan Golubovsky,3,153,8,33,2,41,4,56,1,7,0,8,0,0,0,0,0,0
Zac Rinaldo,3,95,6,10,33,16,4,223,8,16,33,24,0,0,0,0,0,0
Zach Redmond,4,153,22,53,2,75,3,77,7,20,0,27,0,0,0,0,0,0
Brent Burns,1,1,0,1,0,1,11,715,114,234,5,348,0,0,0,0,0,0
Chris Gratton,1,24,3,12,0,15,11,798,147,252,51,399,0,0,0,0,0,0
Christian Ehrhoff,1,27,4,10,0,14,11,741,72,255,7,327,0,0,0,0,0,0
Fedor Tyutin,1,43,5,9,0,14,11,742,53,195,4,248,0,0,0,0,0,0
Jarkko Ruutu,1,65,26,32,4,58,11,652,58,84,44,142,0,0,0,0,0,0
Mathieu Dandenault,1,19,1,1,0,2,11,769,60,119,5,179,0,0,0,0,0,0
Mike Sillinger,1,3,1,3,0,4,11,753,193,214,1,407,0,0,0,0,0,0
Milan Michalek,1,7,2,2,0,4,11,697,200,228,7,428,0,0,0,0,0,0
Pierre-Marc Bouchard,1,44,9,28,0,37,11,593,110,246,1,356,0,0,0,0,0,0
Ryan Kesler,1,33,3,8,1,11,11,736,202,238,23,440,0,0,0,0,0,0
Steve Reinprecht,1,62,13,30,0,43,11,663,140,242,0,382,0,0,0,0,0,0
Tim Connolly,1,28,5,7,1,12,11,697,131,300,2,431,0,0,0,0,0,0
Tim Gleason,1,22,0,8,1,8,11,727,17,125,49,142,0,0,0,0,0,0
Trevor Daley,1,40,8,6,2,14,11,756,67,164,11,231,0,0,0,0,0,0
Aaron Ness,5,280,23,100,0,123,2,29,1,2,0,3,0,0,0,0,0,0
Alexander Semin,1,4,3,1,0,4,10,635,238,275,1,513,0,0,0,0,0,0
Andreas Thuresson,5,350,66,73,1,139,2,25,1,2,0,3,0,0,0,0,0,0
Artem Chubarov,2,33,14,18,0,32,5,228,25,33,0,58,0,0,0,0,0,0
Ben Chiarot,5,169,12,31,11,43,2,41,2,6,2,8,0,0,0,0,0,0
Cameron Gaunce,5,344,17,80,25,97,2,20,1,0,3,1,0,0,0,0,0,0
Chris Armstrong,5,344,45,174,2,219,2,7,0,1,0,1,0,0,0,0,0,0
Cody Hodgson,2,71,22,27,0,49,5,289,61,73,0,134,0,0,0,0,0,0
Colin Greening,2,71,20,27,6,47,5,255,38,49,9,87,0,0,0,0,0,0
Corey Perry,1,19,16,18,2,34,10,722,296,306,33,602,0,0,0,0,0,0
Daniel Goneau,5,221,60,66,0,126,2,12,2,0,0,2,0,0,0,0,0,0
David Warsofsky,5,230,18,77,2,95,2,10,1,2,0,3,0,0,0,0,0,0
Dennis Wideman,1,12,2,4,1,6,10,707,92,258,6,350,0,0,0,0,0,0
Denny Lambert,2,78,24,24,6,48,5,361,22,39,88,61,0,0,0,0,0,0
Derek Grant,5,256,61,56,4,117,2,25,0,2,0,2,0,0,0,0,0,0
Dixon Ward,2,134,46,82,6,128,5,291,46,59,3,105,0,0,0,0,0,0
Dominic Moore,1,70,14,25,0,39,10,685,83,147,4,230,0,0,0,0,0,0
Eric Healey,10,668,261,298,9,559,1,2,0,0,0,0,0,0,0,0,0,0
Eric O'Dell,5,180,72,76,2,148,2,41,3,5,1,8,0,0,0,0,0,0
Erik Condra,2,135,28,57,1,85,5,299,33,54,3,87,0,0,0,0,0,0
Espen Knutsen,2,43,5,14,0,19,5,207,30,81,1,111,0,0,0,0,0,0
Gabe Gauthier,5,274,57,122,2,179,2,8,0,0,0,0,0,0,0,0,0,0
Greg Nemisz,5,241,46,60,3,106,2,15,0,1,0,1,0,0,0,0,0,0
Jeff Ware,5,287,1,22,39,23,2,8,0,1,0,1,0,0,0,0,0,0
Jerry D'Amigo,5,299,61,83,10,144,2,31,1,2,0,3,0,0,0,0,0,0
Joe Whitney,5,278,86,123,1,209,2,5,1,0,0,1,0,0,0,0,0,0
Joey Mormina,10,620,31,114,42,145,1,1,0,0,0,0,0,0,0,0,0,0
Jon Klemm,1,41,0,6,0,6,10,622,29,72,1,101,0,0,0,0,0,0
Jordan LaVallee-Smotherman,5,368,79,86,25,165,2,4,1,1,0,2,0,0,0,0,0,0
Jordan Szwarz,5,191,35,54,7,89,2,35,4,0,1,4,0,0,0,0,0,0
Kevin Shattenkirk,2,13,0,2,0,2,5,338,41,157,2,198,0,0,0,0,0,0
Kirill Safronov,5,310,21,84,3,105,2,35,2,2,0,4,0,0,0,0,0,0
Kyle McLaren,1,22,1,6,1,7,10,587,36,140,19,176,0,0,0,0,0,0
Lee Stempniak,1,25,8,7,2,15,10,708,165,204,7,369,0,0,0,0,0,0
Lukas Kaspar,5,300,61,103,0,164,2,16,2,2,0,4,0,0,0,0,0,0
Luke Gazdic,5,261,29,28,62,57,2,107,4,3,22,7,0,0,0,0,0,0
Marcel Goc,1,78,16,21,0,37,10,636,75,113,1,188,0,0,0,0,0,0
Marek Malik,1,21,2,8,0,10,10,636,32,129,4,161,0,0,0,0,0,0
Mark Cundari,5,281,36,89,20,125,2,8,1,2,0,3,0,0,0,0,0,0
Mark Streit,1,43,3,12,0,15,10,654,84,300,0,384,0,0,0,0,0,0
Martin Lapointe,1,3,0,0,0,0,10,759,147,165,46,312,0,0,0,0,0,0
Mats Zuccarello,2,73,25,40,0,65,5,222,45,97,1,142,0,0,0,0,0,0
Matt Carle,1,3,0,2,0,2,10,660,43,230,2,273,0,0,0,0,0,0
Matt Henderson,5,357,75,118,10,193,2,6,0,1,0,1,0,0,0,0,0,0
Maxim Afinogenov,1,15,6,12,0,18,10,651,158,237,8,395,0,0,0,0,0,0
Maxim Noreau,5,318,58,133,17,191,2,6,0,0,0,0,0,0,0,0,0,0
Michal Jordan,5,297,20,72,2,92,2,43,2,4,0,6,0,0,0,0,0,0
Mike Richards,1,16,3,11,0,14,10,710,179,303,33,482,0,0,0,0,0,0
Mike Sislo,5,247,65,69,1,134,2,24,0,1,0,1,0,0,0,0,0,0
Mike Stuart,5,231,2,36,3,38,2,3,0,0,0,0,0,0,0,0,0,0
Miroslav Zalesak,5,306,125,115,0,240,2,12,1,2,0,3,0,0,0,0,0,0
Nick Leddy,2,53,5,21,0,26,5,336,30,100,0,130,0,0,0,0,0,0
Nils Ekman,2,114,60,72,2,132,5,264,60,91,2,151,0,0,0,0,0,0
Nolan Pratt,1,54,3,15,12,18,10,583,9,54,33,63,0,0,0,0,0,0
Oliver Ekman-Larsson,2,35,10,21,0,31,5,340,55,99,1,154,0,0,0,0,0,0
Oliver Lauridsen,5,264,9,25,32,34,2,16,2,1,2,3,0,0,0,0,0,0
Oskars Bartulis,5,189,6,44,1,50,2,66,1,8,0,9,0,0,0,0,0,0
Peter Olvecky,5,308,61,92,0,153,2,32,2,5,0,7,0,0,0,0,0,0
R.J. Umberger,1,6,3,5,0,8,10,740,178,203,10,381,0,0,0,0,0,0
Richard Scott,5,182,6,20,76,26,2,10,0,0,4,0,0,0,0,0,0,0
Rob Zettler,2,59,3,11,5,14,5,151,1,17,13,18,0,0,0,0,0,0
Sami Lepisto,2,125,8,79,1,87,5,176,6,29,1,35,0,0,0,0,0,0
Sandis Ozolinsh,1,2,0,1,0,1,10,556,88,242,2,330,0,0,0,0,0,0
Scott Timmins,5,282,55,83,1,138,2,24,1,0,0,1,0,0,0,0,0,0
Sebastien Bordeleau,2,52,13,19,1,32,5,219,35,52,1,87,0,0,0,0,0,0
Sergei Brylin,1,44,21,22,0,43,10,660,117,164,1,281,0,0,0,0,0,0
Steve Wagner,5,219,21,66,3,87,2,46,4,8,0,12,0,0,0,0,0,0
Tom Wandell,2,64,10,13,0,23,5,229,20,23,0,43,0,0,0,0,0,0
Tommy Wingels,2,98,30,24,6,54,5,232,39,57,7,96,0,0,0,0,0,0
Wes O'Neill,5,199,9,26,6,35,2,5,0,0,0,0,0,0,0,0,0,0
Will Acton,5,239,39,40,17,79,2,33,3,2,4,5,0,0,0,0,0,0
Yann Sauve,5,213,7,34,12,41,2,8,0,0,0,0,0,0,0,0,0,0
Zach Sill,5,277,33,40,35,73,2,83,1,3,12,4,0,0,0,0,0,0
Alexander Suglobov,3,133,47,46,2,93,3,18,1,0,0,1,0,0,0,0,0,0
Alexander Svitov,3,52,17,19,5,36,3,179,13,24,6,37,0,0,0,0,0,0
Andre Roy,1,36,3,11,8,14,9,502,35,31,111,66,0,0,0,0,0,0
Andrei Bashkirov,3,144,52,63,1,115,3,30,0,3,0,3,0,0,0,0,0,0
Andrew Alberts,1,5,0,0,1,0,9,459,8,47,23,55,0,0,0,0,0,0
Andy Greene,1,52,5,16,0,21,9,559,31,140,0,171,0,0,0,0,0,0
Antoine Roussel,3,146,13,23,30,36,3,200,34,34,31,68,0,0,0,0,0,0
Antti Miettinen,1,48,7,23,0,30,9,539,97,133,0,230,0,0,0,0,0,0
Barry Richter,3,145,20,76,1,96,3,97,6,20,0,26,0,0,0,0,0,0
Beau Bennett,3,44,7,27,0,34,3,96,10,23,0,33,0,0,0,0,0,0
Byron Bitz,3,122,18,28,14,46,3,97,10,12,9,22,0,0,0,0,0,0
Calvin de Haan,3,76,3,18,0,21,3,117,4,24,0,28,0,0,0,0,0,0
Chris Brown,3,195,62,53,19,115,3,22,2,1,1,3,0,0,0,0,0,0
Chris Wells,3,57,13,13,2,26,3,94,5,12,5,17,0,0,0,0,0,0
Christian Berglund,3,112,33,54,3,87,3,86,11,16,1,27,0,0,0,0,0,0
Corey Tropp,3,109,21,45,15,66,3,148,6,21,11,27,0,0,0,0,0,0
Dan Carcillo,3,108,34,23,30,57,3,119,10,6,13,16,0,0,0,0,0,0
Dan Snyder,3,126,33,48,8,81,3,49,11,5,4,16,0,0,0,0,0,0
Danny Markov,1,52,3,23,2,26,9,538,29,118,6,147,0,0,0,0,0,0
Derek King,3,195,35,77,0,112,3,180,47,60,1,107,0,0,0,0,0,0
Drew Stafford,1,34,22,22,0,44,9,589,154,187,9,341,0,0,0,0,0,0
Dustin Penner,1,57,39,45,2,84,9,589,151,159,8,310,0,0,0,0,0,0
Dwayne Zinger,9,543,24,73,72,97,1,7,0,1,2,1,0,0,0,0,0,0
Eric Charron,3,143,20,47,3,67,3,35,0,1,1,1,0,0,0,0,0,0
Eric Gelinas,3,145,23,41,1,64,3,122,13,35,0,48,0,0,0,0,0,0
Eric Wellwood,3,164,34,32,0,66,3,31,5,5,0,10,0,0,0,0,0,0
Evgeni Dadonov,3,155,33,51,0,84,3,55,10,10,0,20,0,0,0,0,0,0
Frantisek Kaberle,1,4,0,2,0,2,9,523,29,164,0,193,0,0,0,0,0,0
Geoff Platt,3,194,90,89,3,179,3,46,4,10,0,14,0,0,0,0,0,0
J.T. Miller,3,101,29,52,4,81,3,114,15,18,1,33,0,0,0,0,0,0
Jamie Oleksiak,3,163,15,57,2,72,3,59,1,9,0,10,0,0,0,0,0,0
Jan Hejda,1,5,0,3,1,3,9,627,25,110,3,135,0,0,0,0,0,0
Jarred Tinordi,3,158,6,23,17,29,3,43,0,6,7,6,0,0,0,0,0,0
Jean-Gabriel Pageau,3,142,38,56,3,94,3,87,14,11,1,25,0,0,0,0,0,0
Jeff Friesen,1,5,1,4,0,5,9,684,160,223,3,383,0,0,0,0,0,0
Jeremy Welsh,3,193,41,41,0,82,3,25,1,1,0,2,0,0,0,0,0,0
Joe Pavelski,1,16,8,18,0,26,9,643,228,257,4,485,0,0,0,0,0,0
Johan Larsson,3,164,46,76,1,122,3,68,6,14,1,20,0,0,0,0,0,0
Johan Witehall,3,155,41,47,2,88,3,54,2,5,0,7,0,0,0,0,0,0
Johnny Oduya,1,0,0,0,0,0,9,664,31,121,2,152,0,0,0,0,0,0
Kris Letang,1,10,1,6,0,7,9,491,66,219,6,285,0,0,0,0,0,0
Kyle Wellwood,1,76,20,35,0,55,9,489,92,143,0,235,0,0,0,0,0,0
Linus Omark,3,75,34,42,0,76,3,79,8,24,0,32,0,0,0,0,0,0
Marc-Edouard Vlasic,1,1,0,2,0,2,9,670,39,148,4,187,0,0,0,0,0,0
Mark Barberio,3,215,30,104,2,134,3,103,6,11,0,17,0,0,0,0,0,0
Mike Crowley,3,131,20,52,4,72,3,67,5,15,0,20,0,0,0,0,0,0
Mike Ricci,1,2,0,0,0,0,9,620,111,173,2,284,0,0,0,0,0,0
Mike Rucinski,3,170,12,36,5,48,3,26,0,2,0,2,0,0,0,0,0,0
Mikko Lehtonen,3,206,56,68,3,124,3,17,1,2,0,3,0,0,0,0,0,0
Nathan Beaulieu,3,132,16,46,5,62,3,87,1,12,4,13,0,0,0,0,0,0
Niclas Havelid,1,2,0,0,0,0,9,628,34,137,0,171,0,0,0,0,0,0
Nicolas Blanchard,9,531,64,80,101,144,1,9,0,0,4,0,0,0,0,0,0,0
Petr Tenkrat,3,39,13,19,0,32,3,177,22,30,0,52,0,0,0,0,0,0
Phil Kessel,1,2,1,0,0,1,9,668,247,273,3,520,0,0,0,0,0,0
Richard Matvichuk,1,42,1,3,0,4,9,574,26,108,2,134,0,0,0,0,0,0
Rickard Wallin,3,151,40,62,0,102,3,79,8,11,0,19,0,0,0,0,0,0
Riku Hahl,3,108,20,31,2,51,3,92,5,8,0,13,0,0,0,0,0,0
Rob Brown,3,198,59,150,3,209,3,190,38,49,2,87,0,0,0,0,0,0
Rob Globke,3,164,22,32,1,54,3,46,1,1,0,2,0,0,0,0,0,0
Sean Bergenheim,1,55,25,22,1,47,9,506,96,84,4,180,0,0,0,0,0,0
Sean Haggerty,3,209,73,73,2,146,3,13,1,2,0,3,0,0,0,0,0,0
Steve Leach,3,19,7,7,0,14,3,132,7,11,10,18,0,0,0,0,0,0
Stewart Malgunas,3,127,16,37,2,53,3,22,0,1,0,1,0,0,0,0,0,0
Teemu Hartikainen,3,164,45,66,4,111,3,52,6,7,0,13,0,0,0,0,0,0
Thomas Pihlman,3,203,30,52,2,82,3,15,1,1,0,2,0,0,0,0,0,0
Tom Gilbert,1,48,4,26,0,30,9,592,43,173,1,216,0,0,0,0,0,0
Travis Zajac,1,2,0,1,0,1,9,625,127,221,4,348,0,0,0,0,0,0
Tye McGinn,3,163,46,33,13,79,3,87,9,8,4,17,0,0,0,0,0,0
Tyler Toffoli,3,77,44,31,0,75,3,148,37,46,0,83,0,0,0,0,0,0
Victor Oreskovich,3,103,16,23,2,39,3,67,2,7,3,9,0,0,0,0,0,0
Alexander Mogilny,1,19,4,10,0,14,8,454,176,232,1,408,0,0,0,0,0,0
Anders Myrvold,4,234,12,70,3,82,2,20,0,2,0,2,0,0,0,0,0,0
Andrei Nazarov,1,1,0,0,0,0,8,442,31,44,123,75,0,0,0,0,0,0
Andrew Joudrey,8,492,77,105,1,182,1,1,0,0,0,0,0,0,0,0,0,0
Andrew Shaw,2,66,20,17,10,37,4,244,56,47,10,103,0,0,0,0,0,0
Antti Aalto,2,69,18,35,1,53,4,151,11,17,0,28,0,0,0,0,0,0
Brad Church,8,276,45,66,17,111,1,2,0,0,0,0,0,0,0,0,0,0
Brad Hunt,4,207,35,104,0,139,2,14,1,2,0,3,0,0,0,0,0,0
Brandon Gormley,4,149,16,60,0,76,2,32,2,2,0,4,0,0,0,0,0,0
Brett MacLean,4,254,99,104,3,203,2,18,2,3,0,5,0,0,0,0,0,0
Brian Fahey,8,501,56,129,10,185,1,7,0,1,0,1,0,0,0,0,0,0
Brian Gibbons,4,194,33,68,1,101,2,66,5,17,0,22,0,0,0,0,0,0
Brian White,8,473,15,61,5,76,1,2,0,0,0,0,0,0,0,0,0,0
Bryan Lerg,8,348,89,106,4,195,1,2,1,0,0,1,0,0,0,0,0,0
Bryan Little,1,34,9,16,0,25,8,556,146,197,2,343,0,0,0,0,0,0
Bryan Young,4,176,3,15,4,18,2,17,0,0,0,0,0,0,0,0,0,0
Casey Cizikas,2,83,25,41,1,66,4,210,21,32,0,53,0,0,0,0,0,0
Chad Kolarik,4,277,98,111,5,209,2,6,0,1,0,1,0,0,0,0,0,0
Charlie Stephens,4,297,77,136,3,213,2,8,0,2,0,2,0,0,0,0,0,0
Chris Joseph,2,57,11,32,0,43,4,107,4,13,1,17,0,0,0,0,0,0
Chris Kenady,4,218,47,57,27,104,2,7,0,2,0,2,0,0,0,0,0,0
Chris Schmidt,8,425,79,100,16,179,1,10,0,2,1,2,0,0,0,0,0,0
Chris Therien,1,2,0,0,0,0,8,563,18,81,7,99,0,0,0,0,0,0
Craig Millar,2,103,13,39,5,52,4,113,8,14,0,22,0,0,0,0,0,0
Damian Surma,4,185,25,27,5,52,2,2,1,1,0,2,0,0,0,0,0,0
Dan Sexton,4,144,36,64,0,100,2,88,13,19,0,32,0,0,0,0,0,0
Darcy Verot,8,434,44,74,108,118,1,37,0,2,12,2,0,0,0,0,0,0
David Jones,1,45,14,16,0,30,8,387,93,80,2,173,0,0,0,0,0,0
David Nemirovsky,4,117,32,51,1,83,2,43,9,13,0,22,0,0,0,0,0,0
Derek Peltier,4,174,6,40,1,46,2,14,0,0,0,0,0,0,0,0,0,0
Derick Brassard,1,42,15,36,1,51,8,483,100,185,4,285,0,0,0,0,0,0
Drew Bagnall,8,474,9,61,66,70,1,2,0,0,0,0,0,0,0,0,0,0
Dwight Helminen,4,285,74,72,1,146,2,27,2,1,0,3,0,0,0,0,0,0
Evgeny Grachev,4,268,42,60,0,102,2,34,1,3,0,4,0,0,0,0,0,0
Garrett Wilson,4,179,41,33,14,74,2,5,0,0,0,0,0,0,0,0,0,0
Gavin Morgan,8,523,81,151,65,232,1,6,0,0,4,0,0,0,0,0,0,0
Greg McKegg,4,190,50,58,3,108,2,4,0,0,0,0,0,0,0,0,0,0
Hugh Jessiman,8,498,117,112,59,229,1,2,0,0,1,0,0,0,0,0,0,0
James Black,2,34,8,13,0,21,4,218,35,33,0,68,0,0,0,0,0,0
Jamie Tardif,8,489,141,125,29,266,1,2,0,0,0,0,0,0,0,0,0,0
Jason Bonsignore,4,135,26,47,0,73,2,58,2,11,0,13,0,0,0,0,0,0
Jason Zucker,2,77,32,31,2,63,4,98,29,9,0,38,0,0,0,0,0,0
Jeff Daw,8,492,142,185,1,327,1,1,0,1,0,1,0,0,0,0,0,0
Jonas Andersson,4,189,32,31,1,63,2,9,0,0,0,0,0,0,0,0,0,0
Jonathan Marchessault,4,295,92,162,2,254,2,4,1,1,0,2,0,0,0,0,0,0
Josh Leivo,4,115,34,42,3,76,2,16,2,1,0,3,0,0,0,0,0,0
Justin Faulk,2,43,7,23,1,30,4,262,33,85,3,118,0,0,0,0,0,0
Karl Stollery,4,209,21,70,3,91,2,12,0,0,0,0,0,0,0,0,0,0
Ken Gernander,8,605,172,198,0,370,1,2,0,0,0,0,0,0,0,0,0,0
Kevan Miller,4,154,7,38,21,45,2,88,3,10,5,13,0,0,0,0,0,0
Kevin Dean,2,78,5,15,1,20,4,245,5,37,0,42,0,0,0,0,0,0
Kyle Okposo,1,35,9,19,0,28,8,450,117,188,2,305,0,0,0,0,0,0
Lasse Kukkonen,2,84,3,22,1,25,4,159,6,16,1,22,0,0,0,0,0,0
Louis Leblanc,4,234,48,49,2,97,2,50,5,5,0,10,0,0,0,0,0,0
Marcus Foligno,2,93,26,40,7,66,4,192,26,44,13,70,0,0,0,0,0,0
Mark Lawrence,2,39,14,10,0,24,4,127,18,25,2,43,0,0,0,0,0,0
Matt Niskanen,1,13,0,3,0,3,8,573,39,159,8,198,0,0,0,0,0,0
Matt Tennyson,4,164,17,48,1,65,2,31,2,8,0,10,0,0,0,0,0,0
Maxim Galanov,2,87,12,36,0,48,4,122,8,12,0,20,0,0,0,0,0,0
Michael Latta,4,183,38,62,37,100,2,70,1,9,10,10,0,0,0,0,0,0
Mika Zibanejad,2,29,6,12,0,18,4,200,43,57,0,100,0,0,0,0,0,0
Mike Craig,4,254,122,103,0,225,2,3,0,0,0,0,0,0,0,0,0,0
Mike Gaul,4,256,52,185,3,237,2,3,0,0,0,0,0,0,0,0,0,0
Mike Iggulden,4,300,106,130,5,236,2,12,1,4,0,5,0,0,0,0,0,0
Mike Matteucci,4,278,6,28,28,34,2,6,0,0,0,0,0,0,0,0,0,0
Mike Moore,8,419,29,94,42,123,1,6,1,0,1,1,0,0,0,0,0,0
Nathan Robinson,4,245,59,85,2,144,2,7,0,0,0,0,0,0,0,0,0,0
Nick Foligno,1,28,6,13,0,19,8,545,116,163,21,279,0,0,0,0,0,0
Paul Brousseau,4,215,104,104,2,208,2,12,0,2,2,2,0,0,0,0,0,0
Paul Carey,4,188,42,54,3,96,2,22,0,1,0,1,0,0,0,0,0,0
Per Svartvadet,2,6,0,0,0,0,4,247,17,34,0,51,0,0,0,0,0,0
Petr Nedved,1,14,4,7,0,11,8,541,152,228,1,380,0,0,0,0,0,0
Phil Varone,4,262,55,137,0,192,2,37,4,3,0,7,0,0,0,0,0,0
Phillip Samuelsson,4,248,11,54,11,65,2,9,0,0,0,0,0,0,0,0,0,0
Radek Smolenak,4,207,48,55,30,103,2,7,0,1,3,1,0,0,0,0,0,0
Reid Boucher,4,130,40,33,0,73,2,34,3,5,0,8,0,0,0,0,0,0
Rem Murray,1,54,11,24,0,35,8,478,83,101,1,184,0,0,0,0,0,0
Rick Mrozik,8,488,21,69,8,90,1,2,0,0,0,0,0,0,0,0,0,0
Rob DiMaio,1,3,1,1,0,2,8,546,58,111,24,169,0,0,0,0,0,0
Rob Skrlac,8,344,6,12,132,18,1,8,1,0,4,1,0,0,0,0,0,0
Roman Josi,2,74,7,37,0,44,4,253,38,91,0,129,0,0,0,0,0,0
Ryan Christie,4,214,41,46,13,87,2,7,0,0,0,0,0,0,0,0,0,0
Ryan Ellis,2,61,9,23,0,32,4,202,20,51,2,71,0,0,0,0,0,0
Ryan Garbutt,2,115,35,35,4,70,4,198,30,40,7,70,0,0,0,0,0,0
Ryan Vesce,4,262,72,147,1,219,2,19,3,2,0,5,0,0,0,0,0,0
Sasha Goc,4,220,23,77,0,100,2,22,0,0,0,0,0,0,0,0,0,0
Sasha Lakovic,4,142,21,32,38,53,2,18,0,3,7,3,0,0,0,0,0,0
Shawn McEachern,1,10,2,4,0,6,8,545,160,202,1,362,0,0,0,0,0,0
Steve Bancroft,8,483,57,196,10,253,1,5,0,1,0,1,0,0,0,0,0,0
Steve McLaren,8,338,10,11,110,21,1,6,0,0,5,0,0,0,0,0,0,0
Terry Ryan,4,184,44,63,68,107,2,5,0,0,4,0,0,0,0,0,0,0
Terry Yake,2,79,19,49,0,68,4,198,29,50,0,79,0,0,0,0,0,0
Todd Harvey,1,13,6,1,1,7,8,491,62,81,33,143,0,0,0,0,0,0
Tomas Kurka,4,248,53,65,0,118,2,17,3,2,0,5,0,0,0,0,0,0
Tomas Zizka,4,238,34,101,0,135,2,25,2,6,0,8,0,0,0,0,0,0
Tony Salmelainen,4,194,49,63,1,112,2,70,6,12,0,18,0,0,0,0,0,0
Tyler Wright,1,25,5,15,2,20,8,527,74,67,32,141,0,0,0,0,0,0
Vaclav Varada,1,45,30,26,2,56,8,487,58,125,8,183,0,0,0,0,0,0
Valeri Zelepukin,2,56,18,19,0,37,4,255,34,52,4,86,0,0,0,0,0,0
Vitali Vishnevsky,1,35,1,3,0,4,8,552,16,52,9,68,0,0,0,0,0,0
Wojtek Wolski,1,6,3,2,0,5,8,451,99,168,1,267,0,0,0,0,0,0
Xavier Delisle,4,230,53,93,2,146,2,16,3,2,0,5,0,0,0,0,0,0
Zach Trotman,4,150,13,43,3,56,2,29,1,4,0,5,0,0,0,0,0,0
Zack Kassian,2,59,23,24,4,47,4,198,35,31,16,66,0,0,0,0,0,0
Alex Brooks,7,408,3,44,12,47,1,19,0,1,0,1,0,0,0,0,0,0
Alex Pietrangelo,1,1,0,0,0,0,7,386,44,174,1,218,0,0,0,0,0,0
Andrei Nikolishin,1,2,0,0,0,0,7,457,62,121,1,183,0,0,0,0,0,0
Andrew Bodnarchuk,7,473,30,104,11,134,1,5,0,0,0,0,0,0,0,0,0,0
Bobby Robins,7,282,22,37,89,59,1,3,0,0,2,0,0,0,0,0,0,0
Brett Skinner,7,410,29,160,3,189,1,11,0,0,0,0,0,0,0,0,0,0
Chris Campoli,1,15,3,3,0,6,7,440,35,111,4,146,0,0,0,0,0,0
Chris Kelleher,7,405,32,122,1,154,1,1,0,0,0,0,0,0,0,0,0,0
Chris Tamer,1,14,0,3,0,3,7,481,13,50,75,63,0,0,0,0,0,0
Claude Lapointe,1,2,1,1,0,2,7,518,70,95,2,165,0,0,0,0,0,0
Claude Lemieux,1,23,3,8,0,11,7,457,107,132,6,239,0,0,0,0,0,0
Dane Jackson,7,400,76,110,9,186,1,8,1,1,0,2,0,0,0,0,0,0
Dean Melanson,7,424,39,97,26,136,1,4,0,0,0,0,0,0,0,0,0,0
Derek Whitmore,7,369,95,77,3,172,1,2,0,0,0,0,0,0,0,0,0,0
Eric Messier,1,6,1,3,0,4,7,385,25,50,0,75,0,0,0,0,0,0
Garrett Burnett,7,269,18,8,149,26,1,39,1,2,25,3,0,0,0,0,0,0
Ian MacNeil,7,426,65,87,27,152,1,2,0,0,0,0,0,0,0,0,0,0
Jan Hrdina,1,72,20,24,0,44,7,513,101,196,0,297,0,0,0,0,0,0
Jared Staal,7,232,17,19,4,36,1,2,0,0,0,0,0,0,0,0,0,0
Jeff Finley,1,42,2,10,0,12,7,436,7,34,1,41,0,0,0,0,0,0
Jeff Paul,7,324,12,40,66,52,1,2,0,0,1,0,0,0,0,0,0,0
Josh Bailey,1,11,6,11,0,17,7,476,81,137,3,218,0,0,0,0,0,0
Karl Dykhuis,1,54,5,17,1,22,7,449,30,47,2,77,0,0,0,0,0,0
Ken Belanger,1,10,1,4,0,5,7,220,11,10,49,21,0,0,0,0,0,0
Marc Bergevin,1,2,0,0,0,0,7,413,9,38,16,47,0,0,0,0,0,0
Mark Van Guilder,7,386,61,78,1,139,1,1,0,0,0,0,0,0,0,0,0,0
Matthieu Descoteaux,7,436,41,80,10,121,1,5,1,1,0,2,0,0,0,0,0,0
Nikolai Kulemin,1,5,0,0,0,0,7,503,99,127,1,226,0,0,0,0,0,0
Oleg Kvasha,1,57,13,16,0,29,7,493,81,136,1,217,0,0,0,0,0,0
Patric Hornqvist,1,49,17,18,0,35,7,427,131,136,0,267,0,0,0,0,0,0
Patrik Stefan,1,5,3,0,0,3,7,455,64,124,0,188,0,0,0,0,0,0
Pavel Trnka,1,23,3,5,0,8,7,411,14,63,4,77,0,0,0,0,0,0
Rob Murray,7,523,42,114,28,156,1,13,1,2,0,3,0,0,0,0,0,0
Rob Ray,1,5,2,0,1,2,7,394,10,20,91,30,0,0,0,0,0,0
Rob Zamuner,1,4,0,1,0,1,7,449,76,77,2,153,0,0,0,0,0,0
Ryan Bast,7,476,8,44,56,52,1,2,0,1,0,1,0,0,0,0,0,0
Scott Lachance,1,25,0,4,0,4,7,491,8,52,2,60,0,0,0,0,0,0
Scott Pellerin,1,55,9,24,0,33,7,430,52,104,3,156,0,0,0,0,0,0
Stan Neckar,1,3,0,3,0,3,7,375,8,29,3,37,0,0,0,0,0,0
Steve Brule,7,487,182,250,2,432,1,2,0,0,0,0,0,0,0,0,0,0
Sylvain Cloutier,7,419,59,118,14,177,1,7,0,0,0,0,0,0,0,0,0,0
Trent Klatt,1,24,13,10,0,23,7,479,82,114,1,196,0,0,0,0,0,0
Zach Bogosian,1,5,1,0,0,1,7,414,40,94,10,134,0,0,0,0,0,0
Ales Pisa,3,66,6,14,0,20,2,53,1,3,0,4,0,0,0,0,0,0
Alex Chiasson,2,66,14,26,2,40,3,162,30,38,3,68,0,0,0,0,0,0
Alex Foster,6,312,58,92,3,150,1,3,0,0,0,0,0,0,0,0,0,0
Alex Grant,6,254,32,100,24,132,1,2,2,0,0,2,0,0,0,0,0,0
Alex Khokhlachev,3,137,38,65,0,103,2,4,0,0,0,0,0,0,0,0,0,0
Alex Killorn,2,54,18,26,0,44,3,191,39,59,0,98,0,0,0,0,0,0
Alexandre Boikov,3,193,14,34,13,48,2,10,0,0,1,0,0,0,0,0,0,0
Alexei Smirnov,3,89,23,16,0,39,2,52,3,3,0,6,0,0,0,0,0,0
Anders Lee,2,59,25,21,5,46,3,100,35,22,1,57,0,0,0,0,0,0
Andreas Johansson,1,1,0,0,0,0,6,332,77,78,0,155,0,0,0,0,0,0
Andreas Salomonsson,3,81,17,44,2,61,2,71,5,9,1,14,0,0,0,0,0,0
Andrej Sustr,2,20,3,4,0,7,3,117,1,20,0,21,0,0,0,0,0,0
Anssi Salmela,2,42,8,16,2,24,3,112,4,17,0,21,0,0,0,0,0,0
Bill Sweatt,3,217,50,66,0,116,2,3,0,0,0,0,0,0,0,0,0,0
Blake Geoffrion,3,84,21,43,3,64,2,55,8,5,3,13,0,0,0,0,0,0
Blake Sloan,1,7,4,2,0,6,6,290,11,32,4,43,0,0,0,0,0,0
Branko Radivojevic,1,62,18,21,4,39,6,393,52,68,8,120,0,0,0,0,0,0
Brett Gallant,6,188,6,6,86,12,1,4,0,0,3,0,0,0,0,0,0,0
Brian Bonin,3,188,69,82,1,151,2,12,0,0,0,0,0,0,0,0,0,0
Brian Dumoulin,3,188,15,63,2,78,2,14,1,1,0,2,0,0,0,0,0,0
Brian Flynn,2,50,16,17,0,33,3,168,17,24,0,41,0,0,0,0,0,0
Brock Nelson,3,71,25,28,0,53,2,154,34,34,0,68,0,0,0,0,0,0
Bryan Adams,3,212,26,51,1,77,2,11,0,1,0,1,0,0,0,0,0,0
Carl Gunnarsson,1,12,0,2,0,2,6,365,17,81,0,98,0,0,0,0,0,0
Chad Ruhwedel,2,119,14,50,0,64,3,32,0,2,0,2,0,0,0,0,0,0
Charles Linglet,6,331,96,150,1,246,1,5,0,0,0,0,0,0,0,0,0,0
Chris Allen,3,101,13,34,1,47,2,2,0,0,0,0,0,0,0,0,0,0
Chris Breen,6,297,11,29,19,40,1,9,0,2,1,2,0,0,0,0,0,0
Chris Kreider,2,54,14,13,0,27,3,169,40,46,4,86,0,0,0,0,0,0
Colin Wilson,1,40,13,21,3,34,6,368,77,101,5,178,0,0,0,0,0,0
Conor Allen,3,145,17,48,8,65,2,7,0,0,0,0,0,0,0,0,0,0
Cory Larose,6,427,140,246,15,386,1,7,0,1,0,1,0,0,0,0,0,0
Craig Berube,1,33,0,6,6,6,6,409,20,29,76,49,0,0,0,0,0,0
Curtis Murphy,6,474,99,221,2,320,1,1,0,0,0,0,0,0,0,0,0,0
Daniel Lacroix,2,48,14,9,13,23,3,61,1,4,16,5,0,0,0,0,0,0
Daniel Tkaczuk,6,355,68,127,0,195,1,19,4,7,0,11,0,0,0,0,0,0
Dave Bolland,2,81,23,36,0,59,3,111,21,28,0,49,0,0,0,0,0,0
David Cooper,3,196,53,73,2,126,2,11,0,4,0,4,0,0,0,0,0,0
David Gosselin,3,226,35,65,16,100,2,13,2,1,1,3,0,0,0,0,0,0
David Ullstrom,3,140,50,47,0,97,2,49,6,7,0,13,0,0,0,0,0,0
Denis Pederson,1,1,0,0,0,0,6,355,42,50,32,92,0,0,0,0,0,0
Dmitri Jashkin,2,60,19,25,0,44,3,74,14,6,0,20,0,0,0,0,0,0
Dmitri Nabokov,2,124,25,51,0,76,3,55,11,13,0,24,0,0,0,0,0,0
Doug Friedman,3,169,41,60,17,101,2,18,0,1,4,1,0,0,0,0,0,0
Eriah Hayes,3,125,23,27,2,50,2,19,1,0,0,1,0,0,0,0,0,0
Eric Houde,3,215,86,117,1,203,2,17,2,1,0,3,0,0,0,0,0,0
Erik Karlsson,1,12,0,11,0,11,6,397,84,219,0,303,0,0,0,0,0,0
Evgeni Artyukhin,2,40,5,4,2,9,3,199,19,30,12,49,0,0,0,0,0,0
Francis Belanger,6,277,57,72,54,129,1,10,0,0,4,0,0,0,0,0,0,0
Freddie Hamilton,3,197,46,57,0,103,2,29,1,0,0,1,0,0,0,0,0,0
Grant Stevenson,6,339,83,122,1,205,1,47,10,12,0,22,0,0,0,0,0,0
Greg Crozier,6,395,101,121,4,222,1,1,0,0,0,0,0,0,0,0,0,0
Greg Jacina,3,109,22,28,12,50,2,14,0,1,0,1,0,0,0,0,0,0
Greg Koehler,6,243,65,72,19,137,1,1,0,0,0,0,0,0,0,0,0,0
Greg Pateryn,3,160,25,36,6,61,2,20,0,0,0,0,0,0,0,0,0,0
Igor Radulov,3,162,45,32,0,77,2,43,9,7,0,16,0,0,0,0,0,0
Ilya Zubov,3,138,29,61,0,90,2,11,0,2,0,2,0,0,0,0,0,0
Ivan Vishnevskiy,3,192,21,49,0,70,2,5,0,2,0,2,0,0,0,0,0,0
J.T. Brown,2,64,14,24,4,38,3,120,7,22,3,29,0,0,0,0,0,0
James van Riemsdyk,1,7,1,1,0,2,6,406,122,126,2,248,0,0,0,0,0,0
Jamie Huscroft,2,62,0,13,4,13,3,95,0,6,23,6,0,0,0,0,0,0
Jan Hlavac,1,3,1,0,0,1,6,436,90,134,1,224,0,0,0,0,0,0
Jarno Kultanen,2,118,18,50,0,68,3,102,2,11,1,13,0,0,0,0,0,0
Jaroslav Bednar,2,50,18,22,0,40,3,102,10,25,0,35,0,0,0,0,0,0
Jason Zent,3,141,38,30,3,68,2,5,0,0,0,0,0,0,0,0,0,0
Jayson Megna,3,144,40,26,0,66,2,48,5,5,1,10,0,0,0,0,0,0
Jeff Daniels,1,71,24,27,0,51,6,271,9,13,1,22,0,0,0,0,0,0
Jeff Nelson,6,378,79,194,0,273,1,9,2,1,0,3,0,0,0,0,0,0
Jeff Odgers,1,4,0,0,1,0,6,407,20,28,132,48,0,0,0,0,0,0
Jeff Shantz,1,2,0,1,0,1,6,398,48,78,2,126,0,0,0,0,0,0
Jesper Fast,3,60,19,25,0,44,2,69,6,8,0,14,0,0,0,0,0,0
Jesse Winchester,1,4,2,2,0,4,6,285,20,50,11,70,0,0,0,0,0,0
Jim Cummins,1,11,1,4,3,5,6,323,10,22,67,32,0,0,0,0,0,0
Jimmie Olvestad,3,87,7,16,2,23,2,111,3,14,0,17,0,0,0,0,0,0
Joakim Nordstrom,3,92,26,26,2,52,2,54,1,5,0,6,0,0,0,0,0,0
Joel Lundqvist,2,48,18,26,0,44,3,134,7,19,0,26,0,0,0,0,0,0
John Carlson,1,48,4,35,0,39,6,398,45,144,0,189,0,0,0,0,0,0
Jonathan Sigalet,6,354,38,95,13,133,1,1,0,0,0,0,0,0,0,0,0,0
Kaspars Astashenko,3,142,14,32,0,46,2,23,1,2,0,3,0,0,0,0,0,0
Kelly Fairchild,3,150,50,67,1,117,2,11,2,0,0,2,0,0,0,0,0,0
Kevin Colley,6,177,25,38,22,63,1,16,0,0,6,0,0,0,0,0,0,0
Kevin Doell,6,330,65,98,10,163,1,8,0,1,0,1,0,0,0,0,0,0
Kevin Henderson,6,355,50,61,5,111,1,4,1,0,0,1,0,0,0,0,0,0
Kevin Marshall,6,386,11,46,16,57,1,10,0,0,0,0,0,0,0,0,0,0
Kevin Quick,6,176,1,33,0,34,1,6,0,1,0,1,0,0,0,0,0,0
Kris Vernarsky,3,185,32,39,3,71,2,17,1,0,0,1,0,0,0,0,0,0
Lars Eller,1,70,18,39,0,57,6,363,60,70,1,130,0,0,0,0,0,0
Lasse Pirjeta,2,13,2,6,0,8,3,146,23,27,0,50,0,0,0,0,0,0
Lauri Tukonen,3,185,36,67,0,103,2,5,0,0,0,0,0,0,0,0,0,0
Lee Sorochan,3,152,12,53,10,65,2,3,0,0,0,0,0,0,0,0,0,0
Louis Robitaille,6,381,22,50,145,72,1,2,0,0,1,0,0,0,0,0,0,0
Lucas Lessio,3,123,45,42,3,87,2,29,2,3,0,5,0,0,0,0,0,0
Luke Glendening,3,72,13,25,2,38,2,138,13,12,0,25,0,0,0,0,0,0
Marek Posmyk,3,82,2,6,1,8,2,19,1,2,0,3,0,0,0,0,0,0
Marko Tuomainen,2,135,39,73,2,112,3,75,9,9,3,18,0,0,0,0,0,0
Martin Lojek,3,156,13,19,2,32,2,5,0,1,0,1,0,0,0,0,0,0
Martin Samuelsson,3,184,49,39,3,88,2,14,0,1,0,1,0,0,0,0,0,0
Matt Anderson,6,342,76,131,1,207,1,2,0,1,0,1,0,0,0,0,0,0
Matt Lindblad,3,106,18,33,0,51,2,4,0,0,0,0,0,0,0,0,0,0
Max Talbot,2,47,16,20,1,36,3,197,18,37,5,55,0,0,0,0,0,0
Maxim Kondratiev,2,59,7,18,1,25,3,40,1,2,0,3,0,0,0,0,0,0
Michael Caruso,6,353,13,36,2,49,1,2,0,0,0,0,0,0,0,0,0,0
Michael Chaput,3,173,42,56,6,98,2,50,1,5,1,6,0,0,0,0,0,0
Michael Del Zotto,1,11,0,7,0,7,6,381,37,121,0,158,0,0,0,0,0,0
Michael Sgarbossa,3,166,34,68,13,102,2,9,0,1,0,1,0,0,0,0,0,0
Michal Barinka,3,111,5,15,3,20,2,34,0,2,0,2,0,0,0,0,0,0
Mike Kennedy,3,114,26,43,8,69,2,16,0,1,2,1,0,0,0,0,0,0
Mike Maneluk,2,144,77,78,6,155,3,85,11,10,1,21,0,0,0,0,0,0
Mike McBain,3,145,7,22,3,29,2,64,0,7,0,7,0,0,0,0,0,0
Mike Pandolfo,6,302,45,48,7,93,1,3,0,0,0,0,0,0,0,0,0,0
Mikhail Grigorenko,2,52,14,26,1,40,3,68,6,8,0,14,0,0,0,0,0,0
Nate Schmidt,3,65,6,20,0,26,2,68,3,7,0,10,0,0,0,0,0,0
Nick Petrecki,6,310,8,41,39,49,1,1,0,0,0,0,0,0,0,0,0,0
Nick Smith,6,364,48,84,7,132,1,15,0,0,0,0,0,0,0,0,0,0
Nicolas Deslauriers,3,193,24,55,18,79,2,99,6,10,9,16,0,0,0,0,0,0
Niko Kapanen,1,59,13,28,0,41,6,397,36,90,0,126,0,0,0,0,0,0
Nikolai Zherdev,1,1,0,0,0,0,6,421,115,146,1,261,0,0,0,0,0,0
Ondrej Palat,2,117,22,60,1,82,3,170,41,85,0,126,0,0,0,0,0,0
Oskar Osala,3,203,61,60,7,121,2,3,0,0,0,0,0,0,0,0,0,0
P.K. Subban,1,77,18,35,2,53,6,366,57,170,11,227,0,0,0,0,0,0
Patrik Nemeth,3,92,4,20,0,24,2,30,0,3,0,3,0,0,0,0,0,0
Pavel Skrbek,2,115,13,32,2,45,3,12,0,0,0,0,0,0,0,0,0,0
Petr Buzek,1,4,0,1,0,1,6,157,9,22,2,31,0,0,0,0,0,0
Phil Oreskovic,6,216,4,28,40,32,1,10,1,1,3,2,0,0,0,0,0,0
Rhett Rakhshani,3,120,44,69,0,113,2,7,0,0,0,0,0,0,0,0,0,0
Rickard Rakell,2,48,15,26,0,41,3,93,9,26,0,35,0,0,0,0,0,0
Ryan Barnes,6,269,18,28,76,46,1,2,0,0,0,0,0,0,0,0,0,0
Ryan Caldwell,3,193,13,53,12,66,2,4,0,0,0,0,0,0,0,0,0,0
Ryan Kraft,6,335,107,171,1,278,1,7,0,1,0,1,0,0,0,0,0,0
Ryan Ready,6,398,91,129,16,220,1,7,0,1,0,1,0,0,0,0,0,0
Ryan Tobler,6,300,53,88,70,141,1,4,0,0,1,0,0,0,0,0,0,0
Sami Vatanen,2,70,11,41,1,52,3,123,20,40,1,60,0,0,0,0,0,0
Sergei Vyshedkevich,3,150,26,56,1,82,2,30,2,5,0,7,0,0,0,0,0,0
Stanislav Chistov,2,26,6,8,1,14,3,196,19,42,0,61,0,0,0,0,0,0
Sylvain Lefebvre,1,15,0,5,1,5,6,386,6,58,5,64,0,0,0,0,0,0
Taylor Fedun,3,200,24,75,2,99,2,11,2,4,0,6,0,0,0,0,0,0
Teemu Pulkkinen,3,119,65,56,0,121,2,34,5,3,0,8,0,0,0,0,0,0
Todd Warriner,1,32,7,13,0,20,6,316,46,60,0,106,0,0,0,0,0,0
Tomas Divisek,3,178,43,72,0,115,2,5,1,0,0,1,0,0,0,0,0,0
Tomas Kubalik,3,190,49,50,3,99,2,12,1,3,0,4,0,0,0,0,0,0
Toni Dahlman,3,168,18,44,0,62,2,22,1,1,0,2,0,0,0,0,0,0
Trevor Frischmon,6,396,32,98,3,130,1,3,0,0,0,0,0,0,0,0,0,0
Tyler Bozak,1,32,4,16,0,20,6,378,95,137,0,232,0,0,0,0,0,0
Ville Koistinen,2,67,10,33,0,43,3,103,8,24,0,32,0,0,0,0,0,0
Ville Leino,1,57,15,31,0,46,6,286,40,79,0,119,0,0,0,0,0,0
Vladimir Vorobiev,3,166,56,84,0,140,2,17,4,2,0,6,0,0,0,0,0,0
Vladislav Namestnikov,3,134,40,64,4,104,2,47,9,7,1,16,0,0,0,0,0,0
Vojtech Polak,3,162,35,60,0,95,2,5,0,0,0,0,0,0,0,0,0,0
Warren Luhning,2,107,26,27,6,53,3,29,0,1,1,1,0,0,0,0,0,0
Aaron MacKenzie,5,291,11,36,4,47,1,5,0,0,0,0,0,0,0,0,0,0
Alex Biega,5,333,19,88,3,107,1,7,1,0,0,1,0,0,0,0,0,0
Benoit Brunet,1,5,3,1,0,4,5,274,52,77,2,129,0,0,0,0,0,0
Bill Muckalt,1,9,0,3,0,3,5,256,40,57,12,97,0,0,0,0,0,0
Brandon DeFazio,5,288,60,58,24,118,1,2,0,0,0,0,0,0,0,0,0,0
Bruce Gardiner,1,45,5,18,0,23,5,245,23,44,4,67,0,0,0,0,0,0
Carter Camper,5,264,56,144,0,200,1,3,1,0,0,1,0,0,0,0,0,0
Chad Rau,5,327,65,88,0,153,1,9,2,0,0,2,0,0,0,0,0,0
Chris Bala,5,259,49,63,0,112,1,6,0,1,0,1,0,0,0,0,0,0
Chris Corrinet,5,192,27,50,10,77,1,8,0,1,1,1,0,0,0,0,0,0
Colby Cohen,5,166,6,37,7,43,1,3,0,0,0,0,0,0,0,0,0,0
Daniel Bois,5,337,64,65,50,129,1,1,0,0,1,0,0,0,0,0,0,0
Danny Irmen,5,304,47,63,10,110,1,2,0,0,0,0,0,0,0,0,0,0
Dave Dziurzynski,5,308,38,69,27,107,1,12,2,0,1,2,0,0,0,0,0,0
Dave Manson,1,2,0,0,0,0,5,340,15,65,11,80,0,0,0,0,0,0
Dave Van Drunen,5,297,10,29,3,39,1,1,0,0,0,0,0,0,0,0,0,0
David Brine,5,303,37,68,2,105,1,9,0,1,1,1,0,0,0,0,0,0
David Laliberte,5,250,61,77,5,138,1,11,2,1,0,3,0,0,0,0,0,0
David McIntyre,5,285,54,68,8,122,1,7,1,1,0,2,0,0,0,0,0,0
Dick Tarnstrom,1,9,0,2,0,2,5,306,35,105,0,140,0,0,0,0,0,0
Eric Selleck,5,332,30,46,99,76,1,2,0,1,1,1,0,0,0,0,0,0
Gaetan Royer,5,179,19,18,37,37,1,3,0,0,0,0,0,0,0,0,0,0
Gino Odjick,1,13,2,1,2,3,5,196,21,23,33,44,0,0,0,0,0,0
Gord Murphy,1,8,0,3,0,3,5,230,10,41,1,51,0,0,0,0,0,0
Jamie Fraser,5,262,27,55,0,82,1,1,0,0,0,0,0,0,0,0,0,0
Jeff MacMillan,5,384,27,38,21,65,1,4,0,0,0,0,0,0,0,0,0,0
Jeff Penner,5,247,25,73,0,98,1,2,0,0,0,0,0,0,0,0,0,0
Jesse Blacker,5,235,17,59,4,76,1,1,0,0,0,0,0,0,0,0,0,0
John MacLean,1,5,0,1,0,1,5,286,69,83,2,152,0,0,0,0,0,0
Jon Rheault,5,261,56,75,3,131,1,5,0,0,0,0,0,0,0,0,0,0
Jonathan Delisle,5,313,35,90,45,125,1,1,0,0,0,0,0,0,0,0,0,0
Justin Kurtz,5,253,35,94,3,129,1,27,3,5,0,8,0,0,0,0,0,0
Justin Mercier,5,255,43,42,5,85,1,9,1,1,0,2,0,0,0,0,0,0
Kael Mouillierat,5,229,63,107,7,170,1,6,1,1,0,2,0,0,0,0,0,0
Kris Chucko,5,277,66,61,11,127,1,2,0,0,0,0,0,0,0,0,0,0
Kris Fredheim,5,299,10,30,4,40,1,3,0,0,0,0,0,0,0,0,0,0
Larry Courville,5,282,53,74,12,127,1,11,0,0,1,0,0,0,0,0,0,0
Marc-Andre Bourdon,5,149,5,35,17,40,1,45,4,3,3,7,0,0,0,0,0,0
Marcus Johansson,1,2,0,0,0,0,5,345,61,125,1,186,0,0,0,0,0,0
Marcus Kruger,1,34,8,14,0,22,5,287,28,56,0,84,0,0,0,0,0,0
Mark Fayne,1,19,1,3,0,4,5,316,15,41,1,56,0,0,0,0,0,0
Mathieu Carle,5,294,36,98,4,134,1,3,0,0,0,0,0,0,0,0,0,0
Matt Watkins,5,326,59,91,6,150,1,1,0,0,0,0,0,0,0,0,0,0
Maxime Macenauer,5,290,43,52,2,95,1,29,1,3,0,4,0,0,0,0,0,0
Maxime Sauve,5,213,51,55,1,106,1,1,0,0,0,0,0,0,0,0,0,0
Mike Bishai,5,171,38,50,0,88,1,14,0,2,1,2,0,0,0,0,0,0
Mikhail Kuleshov,5,272,26,43,2,69,1,3,0,0,0,0,0,0,0,0,0,0
Nicolas Deschamps,5,284,52,95,0,147,1,3,0,0,0,0,0,0,0,0,0,0
Nikita Nikitin,1,22,3,11,0,14,5,248,17,58,1,75,0,0,0,0,0,0
Olivier Magnan,5,296,9,51,17,60,1,18,0,0,0,0,0,0,0,0,0,0
Patrick Poulin,1,31,12,7,0,19,5,321,33,51,4,84,0,0,0,0,0,0
Petr Schastlivy,1,31,22,13,0,35,5,129,18,22,0,40,0,0,0,0,0,0
Philippe Cornet,5,290,68,76,3,144,1,2,0,1,0,1,0,0,0,0,0,0
Remi Royer,5,114,6,21,21,27,1,18,0,0,3,0,0,0,0,0,0,0
Rob Collins,5,293,52,113,0,165,1,8,1,1,0,2,0,0,0,0,0,0
Robert Kron,1,6,2,4,0,6,5,355,50,85,0,135,0,0,0,0,0,0
Ryan Jardine,5,291,62,65,5,127,1,8,0,2,0,2,0,0,0,0,0,0
Ryan McDonagh,1,38,1,7,0,8,5,317,34,102,0,136,0,0,0,0,0,0
Scott Lehman,5,106,4,10,14,14,1,1,0,0,0,0,0,0,0,0,0,0
Sean McMorrow,5,251,1,3,151,4,1,1,0,0,0,0,0,0,0,0,0,0
Sergei Krivokrasov,1,15,3,5,0,8,5,283,54,81,1,135,0,0,0,0,0,0
Taylor Hall,1,26,14,20,1,34,5,299,106,157,1,263,0,0,0,0,0,0
Adam Payerl,4,130,10,21,19,31,1,2,0,0,0,0,0,0,0,0,0,0
Alexander Nikulin,2,140,23,52,0,75,2,3,0,0,0,0,0,0,0,0,0,0
Alexander Perezhogin,2,87,23,29,0,52,2,128,15,19,0,34,0,0,0,0,0,0
Alexei Marchenko,2,100,6,32,0,38,2,14,1,1,0,2,0,0,0,0,0,0
Andreas Engqvist,2,131,30,38,0,68,2,15,0,0,0,0,0,0,0,0,0,0
Andrew Agozzino,4,227,67,98,5,165,1,1,0,1,0,1,0,0,0,0,0,0
Andy Andreoff,4,157,30,42,23,72,1,18,2,1,2,3,0,0,0,0,0,0
Antti Pihlstrom,2,93,35,22,1,57,2,54,2,5,0,7,0,0,0,0,0,0
Antti-Jussi Niemi,2,75,13,17,0,30,2,29,1,1,0,2,0,0,0,0,0,0
Austin Watson,4,229,68,59,2,127,1,6,1,0,0,1,0,0,0,0,0,0
B.J. Young,4,236,67,87,35,154,1,1,0,0,0,0,0,0,0,0,0,0
Barrie Moore,4,187,45,72,0,117,1,1,0,0,0,0,0,0,0,0,0,0
Ben Hanowski,2,111,29,27,3,56,2,16,1,2,0,3,0,0,0,0,0,0
Benoit Dusablon,4,173,34,61,3,95,1,3,0,0,0,0,0,0,0,0,0,0
Blair Atcheynum,1,37,12,8,0,20,4,192,27,32,0,59,0,0,0,0,0,0
Bobby Farnham,4,197,17,22,52,39,1,11,0,0,5,0,0,0,0,0,0,0
Boone Jenner,2,10,4,1,0,5,2,103,25,21,1,46,0,0,0,0,0,0
Brad DeFauw,4,215,43,48,0,91,1,9,3,0,0,3,0,0,0,0,0,0
Brad Fast,4,155,15,40,1,55,1,1,1,0,0,1,0,0,0,0,0,0
Brandon Convery,2,82,37,52,3,89,2,22,2,9,0,11,0,0,0,0,0,0
Brandon Nolan,4,154,41,57,9,98,1,6,0,1,0,1,0,0,0,0,0,0
Brandon Saad,1,31,8,12,0,20,4,208,52,74,0,126,0,0,0,0,0,0
Brian Salcido,4,291,36,105,4,141,1,2,0,1,0,1,0,0,0,0,0,0
Brock Trotter,4,214,71,102,0,173,1,2,0,0,0,0,0,0,0,0,0,0
Calle Jarnkrok,2,72,18,30,0,48,2,86,9,18,0,27,0,0,0,0,0,0
Carl Hagelin,1,17,7,6,0,13,4,266,58,72,0,130,0,0,0,0,0,0
Cedric Paquette,2,75,24,27,7,51,2,66,12,8,3,20,0,0,0,0,0,0
Cody Ceci,2,30,3,18,0,21,2,130,8,22,0,30,0,0,0,0,0,0
Corban Knight,2,128,34,46,2,80,2,9,1,0,0,1,0,0,0,0,0,0
Craig Smith,1,4,1,4,0,5,4,277,65,79,0,144,0,0,0,0,0,0
Dale Clarke,4,231,13,57,0,70,1,3,0,0,0,0,0,0,0,0,0,0
Darren Archibald,4,204,37,32,24,69,1,16,1,2,0,3,0,0,0,0,0,0
Darryl Shannon,1,4,0,1,0,1,4,230,12,53,2,65,0,0,0,0,0,0
"Dave ""Moose"" Morissette",2,86,6,8,33,14,2,11,0,0,8,0,0,0,0,0,0,0
Dave Duerden,4,223,64,77,1,141,1,2,0,0,0,0,0,0,0,0,0,0
David Broll,4,114,3,16,27,19,1,5,0,1,1,1,0,0,0,0,0,0
David Printz,2,142,10,26,10,36,2,13,0,0,0,0,0,0,0,0,0,0
Dean Malkoc,2,126,3,12,14,15,2,42,1,1,9,2,0,0,0,0,0,0
Derek Plante,1,57,18,35,0,53,4,168,22,39,1,61,0,0,0,0,0,0
Ed Ward,1,65,14,19,3,33,4,188,13,12,10,25,0,0,0,0,0,0
Eric Perrin,1,71,21,54,0,75,4,245,32,72,0,104,0,0,0,0,0,0
Erik Gudbranson,1,2,0,0,0,0,4,245,9,25,17,34,0,0,0,0,0,0
Erik Haula,2,37,14,15,0,29,2,118,13,16,0,29,0,0,0,0,0,0
Evgeny Namestnikov,2,75,13,23,0,36,2,8,0,1,0,1,0,0,0,0,0,0
Francois Leroux,4,255,9,18,39,27,1,50,1,2,15,3,0,0,0,0,0,0
Geoff Smith,2,93,3,19,0,22,2,19,1,1,0,2,0,0,0,0,0,0
Goran Bezina,4,268,19,29,9,48,1,3,0,0,0,0,0,0,0,0,0,0
Grant Lewis,4,180,11,56,6,67,1,1,0,0,0,0,0,0,0,0,0,0
Jaden Schwartz,1,33,9,10,0,19,4,207,62,73,1,135,0,0,0,0,0,0
Jamie Devane,4,118,6,9,21,15,1,2,0,0,0,0,0,0,0,0,0,0
Jamie Hunt,4,165,14,34,2,48,1,1,0,0,0,0,0,0,0,0,0,0
Janis Sprukts,2,117,34,72,1,106,2,14,1,2,0,3,0,0,0,0,0,0
Jarkko Immonen,2,127,50,65,0,115,2,20,3,5,0,8,0,0,0,0,0,0
Jaroslav Balastik,2,19,5,5,0,10,2,74,13,11,0,24,0,0,0,0,0,0
Jason Ryznar,4,246,26,33,6,59,1,8,0,0,0,0,0,0,0,0,0,0
Jean-Francois Jomphe,2,70,20,40,1,60,2,16,1,3,0,4,0,0,0,0,0,0
Jean-Yves Leroux,1,59,8,16,4,24,4,219,16,21,14,37,0,0,0,0,0,0
Jeff Nielsen,1,18,4,8,0,12,4,250,20,27,3,47,0,0,0,0,0,0
Jeff Ulmer,4,235,36,55,5,91,1,21,3,0,0,3,0,0,0,0,0,0
Jesse Fibiger,4,252,17,46,7,63,1,16,0,0,0,0,0,0,0,0,0,0
Joey Tenute,4,247,77,114,2,191,1,1,0,0,0,0,0,0,0,0,0,0
Johan Davidsson,2,65,10,37,0,47,2,83,6,9,0,15,0,0,0,0,0,0
John Albert,4,217,56,63,0,119,1,9,1,0,0,1,0,0,0,0,0,0
Jon Merrill,2,27,3,15,0,18,2,118,4,21,0,25,0,0,0,0,0,0
Jonas Junland,2,144,27,48,1,75,2,4,0,2,0,2,0,0,0,0,0,0
Jonathan Ferland,4,267,51,56,11,107,1,7,1,0,0,1,0,0,0,0,0,0
Jonathan Hedstrom,2,100,28,42,0,70,2,83,13,14,0,27,0,0,0,0,0,0
Julian Melchiori,4,173,3,22,5,25,1,1,0,0,0,0,0,0,0,0,0,0
Julien Vauclair,4,283,26,76,1,102,1,1,0,0,0,0,0,0,0,0,0,0
Justin Florek,4,221,43,61,3,104,1,4,1,1,0,2,0,0,0,0,0,0
Justin Fontaine,2,137,39,72,0,111,2,137,22,30,0,52,0,0,0,0,0,0
Justin Johnson,4,153,5,11,67,16,1,2,0,0,1,0,0,0,0,0,0,0
Justin Shugg,4,212,49,66,0,115,1,3,0,0,0,0,0,0,0,0,0,0
Keith Jones,1,4,2,1,0,3,4,166,32,56,3,88,0,0,0,0,0,0
Kelly Miller,2,4,0,0,0,0,2,138,9,12,4,21,0,0,0,0,0,0
Kevin Miller,1,74,27,21,0,48,4,83,8,16,3,24,0,0,0,0,0,0
Kurtis McLean,4,224,56,96,6,152,1,4,1,0,0,1,0,0,0,0,0,0
Lonny Bohonos,2,98,53,69,0,122,2,44,8,4,0,12,0,0,0,0,0,0
Lubomir Vaic,2,113,25,44,0,69,2,9,1,1,0,2,0,0,0,0,0,0
Luke Sellars,4,147,12,32,17,44,1,1,0,0,0,0,0,0,0,0,0,0
Mark Janssens,1,28,3,9,1,12,4,198,6,13,28,19,0,0,0,0,0,0
Markus Granlund,2,73,34,29,0,63,2,55,10,11,0,21,0,0,0,0,0,0
Martin Karsums,4,212,54,101,0,155,1,24,1,5,0,6,0,0,0,0,0,0
Martin Spanhel,2,117,18,25,2,43,2,10,2,0,0,2,0,0,0,0,0,0
Matt Nieto,2,13,4,6,0,10,2,138,20,31,0,51,0,0,0,0,0,0
Matt Puempel,4,136,43,38,11,81,1,13,2,1,0,3,0,0,0,0,0,0
Matt Read,1,11,7,6,0,13,4,276,65,76,2,141,0,0,0,0,0,0
Mattias Ekholm,1,59,10,22,0,32,4,145,8,19,0,27,0,0,0,0,0,0
Maxim Balmochnykh,4,170,26,34,1,60,1,6,0,1,0,1,0,0,0,0,0,0
Mel Angelstad,4,220,11,12,61,23,1,2,0,0,0,0,0,0,0,0,0,0
Michael Bournival,2,81,13,26,0,39,2,89,10,9,0,19,0,0,0,0,0,0
Mike Halmo,4,140,34,37,16,71,1,20,1,0,2,1,0,0,0,0,0,0
Mikko Jokela,4,286,32,59,4,91,1,1,0,0,0,0,0,0,0,0,0,0
Nathan LaFayette,2,70,14,23,0,37,2,67,7,5,0,12,0,0,0,0,0,0
Nick Cousins,4,146,33,53,3,86,1,11,0,0,0,0,0,0,0,0,0,0
Nikos Tselios,4,293,16,44,7,60,1,2,0,0,0,0,0,0,0,0,0,0
Oleg Petrov,1,16,7,7,0,14,4,270,52,88,0,140,0,0,0,0,0,0
Oscar Klefbom,2,57,2,16,0,18,2,77,3,20,0,23,0,0,0,0,0,0
Patrick Cote,1,16,0,1,3,1,4,100,1,2,48,3,0,0,0,0,0,0
Patrick Thoresen,2,34,14,18,1,32,2,106,6,18,2,24,0,0,0,0,0,0
Pavel Kolarik,2,98,8,10,0,18,2,23,0,0,0,0,0,0,0,0,0,0
Pavel Vorobiev,2,89,22,32,0,54,2,57,10,15,0,25,0,0,0,0,0,0
Peter Leblanc,4,261,60,72,1,132,1,1,0,0,0,0,0,0,0,0,0,0
Peter Leboutillier,4,203,29,37,42,66,1,12,1,1,1,2,0,0,0,0,0,0
Petr Cajanek,1,4,1,0,0,1,4,269,46,107,1,153,0,0,0,0,0,0
Petr Kanko,4,160,30,27,7,57,1,10,1,0,0,1,0,0,0,0,0,0
Petr Vrana,4,229,50,87,0,137,1,16,1,0,0,1,0,0,0,0,0,0
Petter Granberg,2,126,3,19,0,22,2,8,0,0,0,0,0,0,0,0,0,0
Phil McRae,4,229,57,59,5,116,1,15,1,2,0,3,0,0,0,0,0,0
Philip Danault,4,154,19,47,2,66,1,2,0,0,0,0,0,0,0,0,0,0
Philippe Audet,4,276,75,88,4,163,1,4,0,0,0,0,0,0,0,0,0,0
Pierre Sevigny,4,258,84,110,16,194,1,3,0,0,0,0,0,0,0,0,0,0
Randy Cunneyworth,2,104,18,34,3,52,2,85,4,13,1,17,0,0,0,0,0,0
Reilly Smith,1,45,14,21,0,35,4,203,36,64,1,100,0,0,0,0,0,0
Rob Shearer,4,299,93,152,9,245,1,2,0,0,0,0,0,0,0,0,0,0
Roman Vopat,2,41,11,10,4,21,2,79,0,6,18,6,0,0,0,0,0,0
Ryan Bourque,4,269,47,51,2,98,1,1,0,0,0,0,0,0,0,0,0,0
Ryan Strome,2,47,15,41,1,56,2,118,24,44,1,68,0,0,0,0,0,0
Scott Fraser,2,86,42,56,0,98,2,57,14,15,0,29,0,0,0,0,0,0
Scott Laughton,2,45,15,15,1,30,2,36,2,4,1,6,0,0,0,0,0,0
Sean Bentivoglio,4,241,44,79,1,123,1,1,0,0,0,0,0,0,0,0,0,0
Sean Couturier,1,31,10,18,1,28,4,287,45,73,4,118,0,0,0,0,0,0
Sergei Shirokov,2,152,44,59,1,103,2,8,1,0,0,1,0,0,0,0,0,0
Shawn Lalonde,4,204,13,57,13,70,1,1,0,0,0,0,0,0,0,0,0,0
Spencer Abbott,4,187,49,99,0,148,1,1,0,0,0,0,0,0,0,0,0,0
Stefan Matteau,2,128,25,28,4,53,2,24,2,2,0,4,0,0,0,0,0,0
Steve Maltais,4,301,122,177,0,299,1,26,0,3,0,3,0,0,0,0,0,0
Stuart Percy,4,119,6,34,0,40,1,9,0,3,0,3,0,0,0,0,0,0
Tanner Pearson,2,105,36,43,0,79,2,67,15,8,0,23,0,0,0,0,0,0
Ted Drury,1,67,14,15,1,29,4,215,14,18,6,32,0,0,0,0,0,0
Terran Sandwith,4,231,6,36,24,42,1,8,0,0,0,0,0,0,0,0,0,0
Teuvo Teravainen,2,44,8,19,0,27,2,37,4,5,0,9,0,0,0,0,0,0
Timofei Shishkanov,2,119,40,37,0,77,2,24,3,2,0,5,0,0,0,0,0,0
Tomas Jurco,2,106,27,33,0,60,2,99,11,22,0,33,0,0,0,0,0,0
Tommi Santala,2,56,15,25,0,40,2,63,2,7,0,9,0,0,0,0,0,0
Torey Krug,1,63,13,32,1,45,4,160,26,55,2,81,0,0,0,0,0,0
Travis Turnbull,4,143,26,28,22,54,1,3,1,0,1,1,0,0,0,0,0,0
Tyler Cuma,4,201,2,31,2,33,1,1,0,0,0,0,0,0,0,0,0,0
Vadim Sharifijanov,2,74,24,28,0,52,2,90,16,21,0,37,0,0,0,0,0,0
Vincent Trocheck,2,78,24,37,1,61,2,70,12,18,0,30,0,0,0,0,0,0
Xavier Ouellet,2,122,5,28,0,33,2,25,2,1,0,3,0,0,0,0,0,0
Yuri Babenko,4,287,55,80,7,135,1,3,0,0,0,0,0,0,0,0,0,0
Adam Almqvist,3,144,14,70,0,84,1,2,1,0,0,1,0,0,0,0,0,0
Adam Berti,3,100,9,13,7,22,1,2,0,0,0,0,0,0,0,0,0,0
Adam Clendening,3,196,23,100,1,123,1,21,1,3,0,4,0,0,0,0,0,0
Adam Pineault,3,201,43,59,8,102,1,3,0,0,0,0,0,0,0,0,0,0
Alex Burmistrov,1,22,2,9,0,11,3,194,23,35,1,58,0,0,0,0,0,0
Alex Hicks,1,17,6,5,3,11,3,121,8,22,11,30,0,0,0,0,0,0
Alexander Radulov,1,11,6,12,0,18,3,154,47,55,0,102,0,0,0,0,0,0
Alexander Vasyunov,3,187,39,52,1,91,1,18,1,4,0,5,0,0,0,0,0,0
Alexandre Volchkov,3,121,18,34,1,52,1,3,0,0,0,0,0,0,0,0,0,0
Allan Egeland,3,60,17,32,7,49,1,8,0,0,1,0,0,0,0,0,0,0
Andre Petersson,3,142,48,55,0,103,1,1,0,0,0,0,0,0,0,0,0,0
Andrej Nestrasil,3,120,22,24,0,46,1,54,7,13,0,20,0,0,0,0,0,0
Andrew MacWilliam,3,117,3,13,8,16,1,12,0,2,0,2,0,0,0,0,0,0
Anthony Bitetto,3,177,16,56,8,72,1,7,0,0,1,0,0,0,0,0,0,0
Anton Klementyev,3,99,3,10,0,13,1,1,0,0,0,0,0,0,0,0,0,0
Bill Bowler,3,163,33,103,1,136,1,9,0,2,0,2,0,0,0,0,0,0
Bill Huard,1,13,2,2,2,4,3,34,0,1,6,1,0,0,0,0,0,0
Brad Ralph,3,82,9,23,1,32,1,1,0,0,0,0,0,0,0,0,0,0
Brendan Woods,3,112,18,20,13,38,1,2,0,0,0,0,0,0,0,0,0,0
Brendon Nash,3,158,11,49,4,60,1,2,0,0,0,0,0,0,0,0,0,0
Brett Ritchie,3,106,39,34,3,73,1,31,6,3,0,9,0,0,0,0,0,0
Brian Wesenberg,3,167,43,47,18,90,1,1,0,0,1,0,0,0,0,0,0,0
Cade Fairchild,3,158,10,57,0,67,1,5,0,1,0,1,0,0,0,0,0,0
Carl Sneep,3,133,6,27,4,33,1,1,0,1,0,1,0,0,0,0,0,0
Charlie Coyle,1,47,14,11,0,25,3,189,31,48,3,79,0,0,0,0,0,0
Chay Genoway,3,189,16,59,4,75,1,1,0,1,0,1,0,0,0,0,0,0
Chris Wagner,3,194,37,40,6,77,1,9,0,0,0,0,0,0,0,0,0,0
Colin Hemingway,3,46,9,10,2,19,1,3,0,0,0,0,0,0,0,0,0,0
Corey Elkins,3,173,42,49,4,91,1,3,1,0,0,1,0,0,0,0,0,0
Craig Ferguson,3,186,71,82,1,153,1,3,0,0,0,0,0,0,0,0,0,0
Curtis McKenzie,3,111,33,54,12,87,1,36,4,1,6,5,0,0,0,0,0,0
Dan Keczmer,1,25,1,9,0,10,3,79,1,8,1,9,0,0,0,0,0,0
Daniil Tarasov,3,144,47,45,3,92,1,5,0,1,0,1,0,0,0,0,0,0
Danny Biega,3,135,5,27,1,32,1,10,0,2,0,2,0,0,0,0,0,0
Darcy Campbell,3,115,9,13,1,22,1,1,0,0,0,0,0,0,0,0,0,0
David Sloane,3,23,0,1,1,1,1,1,0,0,0,0,0,0,0,0,0,0
David Wilkie,1,1,0,2,0,2,3,81,3,12,6,15,0,0,0,0,0,0
Dean Sylvester,1,76,35,30,2,65,3,96,21,16,0,37,0,0,0,0,0,0
Doug O'Brien,3,161,13,46,1,59,1,5,0,0,0,0,0,0,0,0,0,0
Enrico Ciccone,1,2,0,0,2,0,3,101,3,5,22,8,0,0,0,0,0,0
Filip Forsberg,1,47,15,19,0,34,3,100,27,42,0,69,0,0,0,0,0,0
Geoff Kinrade,3,164,14,43,6,57,1,1,0,0,0,0,0,0,0,0,0,0
Geordie Kinnear,3,147,3,29,22,32,1,4,0,0,1,0,0,0,0,0,0,0
Harry York,1,1,0,0,0,0,3,170,15,28,1,43,0,0,0,0,0,0
Ilkka Pikkarainen,3,126,17,21,4,38,1,31,1,3,0,4,0,0,0,0,0,0
Jakob Silfverberg,1,34,13,16,0,29,3,181,33,48,0,81,0,0,0,0,0,0
Jakub Petruzalek,3,215,43,86,1,129,1,2,0,1,0,1,0,0,0,0,0,0
Jamie Arniel,3,219,42,60,0,102,1,1,0,0,0,0,0,0,0,0,0,0
Jamie Fritsch,3,19,0,0,0,0,1,1,0,0,0,0,0,0,0,0,0,0
Jarod Palmer,3,117,17,30,13,47,1,6,1,0,0,1,0,0,0,0,0,0
Jaroslav Svejkovsky,1,16,12,7,0,19,3,94,16,16,0,32,0,0,0,0,0,0
Jason Bowen,3,177,10,26,38,36,1,4,0,0,2,0,0,0,0,0,0,0
Jeff Brown,3,18,0,2,0,2,1,60,4,24,0,28,0,0,0,0,0,0
Jeff Lank,3,146,13,23,1,36,1,2,0,0,0,0,0,0,0,0,0,0
Joe Jensen,3,109,22,18,2,40,1,6,1,0,0,1,0,0,0,0,0,0
Joey Hishon,3,112,27,39,0,66,1,13,1,1,0,2,0,0,0,0,0,0
Johan Motin,3,99,2,10,3,12,1,1,0,0,0,0,0,0,0,0,0,0
Johan Sundstrom,3,171,26,42,4,68,1,11,0,1,0,1,0,0,0,0,0,0
John Emmons,1,46,4,8,2,12,3,85,2,4,0,6,0,0,0,0,0,0
John Gruden,1,57,3,14,0,17,3,33,1,1,0,2,0,0,0,0,0,0
Jonas Brodin,1,9,2,2,0,4,3,195,13,34,0,47,0,0,0,0,0,0
Jonathan Racine,3,129,0,13,13,13,1,1,0,0,0,0,0,0,0,0,0,0
Joonas Nattinen,3,156,24,21,0,45,1,1,0,0,0,0,0,0,0,0,0,0
Juha Lind,1,3,1,1,0,2,3,133,9,13,1,22,0,0,0,0,0,0
Justin DiBenedetto,3,173,45,40,8,85,1,8,0,1,0,1,0,0,0,0,0,0
Justin Hodgman,3,142,30,46,4,76,1,5,1,0,0,1,0,0,0,0,0,0
Justin Schultz,1,34,18,30,0,48,3,203,25,66,0,91,0,0,0,0,0,0
Kari Haakana,3,30,0,10,1,10,1,13,0,0,0,0,0,0,0,0,0,0
Kellan Lain,3,88,7,13,8,20,1,9,1,0,1,1,0,0,0,0,0,0
Klas Dahlbeck,3,197,15,37,3,52,1,23,1,3,0,4,0,0,0,0,0,0
Luke Witkowski,3,129,4,16,19,20,1,16,0,0,1,0,0,0,0,0,0,0
MacGregor Sharp,3,113,17,18,3,35,1,8,0,0,0,0,0,0,0,0,0,0
Marc Bureau,1,17,4,7,0,11,3,208,20,17,0,37,0,0,0,0,0,0
Mario Larocque,3,82,8,7,7,15,1,5,0,0,0,0,0,0,0,0,0,0
Mark Alt,3,125,7,31,2,38,1,1,0,0,0,0,0,0,0,0,0,0
Mark Katic,3,125,7,41,0,48,1,11,0,1,0,1,0,0,0,0,0,0
Martin Gendron,3,153,63,71,0,134,1,2,0,0,0,0,0,0,0,0,0,0
Matt Ryan,3,189,28,34,8,62,1,12,0,1,0,1,0,0,0,0,0,0
Max Friberg,3,138,33,48,2,81,1,1,0,0,0,0,0,0,0,0,0,0
Micheal Ferland,3,65,13,20,5,33,1,26,2,3,2,5,0,0,0,0,0,0
Michel Riesen,3,202,61,76,0,137,1,12,0,1,0,1,0,0,0,0,0,0
Miika Elomo,3,164,32,36,4,68,1,2,0,1,0,1,0,0,0,0,0,0
Mikael Granlund,1,29,10,18,0,28,3,158,18,70,0,88,0,0,0,0,0,0
Mikael Holmqvist,1,24,7,7,0,14,3,156,18,17,3,35,0,0,0,0,0,0
Mike Danton,1,69,19,15,7,34,3,87,9,5,14,14,0,0,0,0,0,0
Niklas Andersson,1,37,10,28,2,38,3,40,3,9,0,12,0,0,0,0,0,0
Patrick Coulombe,3,57,6,6,0,12,1,7,0,1,0,1,0,0,0,0,0,0
Paul Manning,3,139,5,14,2,19,1,8,0,0,0,0,0,0,0,0,0,0
Petr Mika,3,91,8,12,1,20,1,3,0,0,0,0,0,0,0,0,0,0
Petr Taticek,3,125,18,40,0,58,1,3,0,0,0,0,0,0,0,0,0,0
Petri Kontiola,3,158,37,93,0,130,1,12,0,5,0,5,0,0,0,0,0,0
Petteri Wirtanen,3,223,32,64,0,96,1,3,1,0,0,1,0,0,0,0,0,0
Prestin Ryan,3,166,23,45,10,68,1,1,0,0,0,0,0,0,0,0,0,0
Robert Petrovicky,1,65,27,34,1,61,3,82,10,14,1,24,0,0,0,0,0,0
Roman Graborenko,3,129,16,37,4,53,1,1,0,0,0,0,0,0,0,0,0,0
Rudy Poeschek,1,5,0,0,0,0,3,78,1,7,15,8,0,0,0,0,0,0
Ryan Sproul,3,140,16,40,1,56,1,1,0,0,0,0,0,0,0,0,0,0
Ryan Thang,3,165,35,50,0,85,1,1,0,0,0,0,0,0,0,0,0,0
Sam Carrick,3,140,25,41,16,66,1,16,1,1,1,2,0,0,0,0,0,0
Scott Mayfield,3,146,4,28,16,32,1,5,0,0,1,0,0,0,0,0,0,0
Scott Thomas,3,102,28,35,0,63,1,24,3,1,1,4,0,0,0,0,0,0
Sean Selmser,3,227,35,43,43,78,1,1,0,0,1,0,0,0,0,0,0,0
Sebastien Bisaillon,3,54,8,14,1,22,1,2,0,0,0,0,0,0,0,0,0,0
Seth Helgeson,3,128,3,19,13,22,1,22,0,2,2,2,0,0,0,0,0,0
Shane Prince,3,206,67,81,6,148,1,2,0,1,0,1,0,0,0,0,0,0
Shawn Burr,1,26,10,14,2,24,3,64,6,9,0,15,0,0,0,0,0,0
Stanislav Galiev,3,100,28,24,0,52,1,2,1,0,0,1,0,0,0,0,0,0
Stefan Della Rovere,3,168,13,15,19,28,1,7,0,0,1,0,0,0,0,0,0,0
Tim Ramholt,3,210,8,38,2,46,1,1,0,0,0,0,0,0,0,0,0,0
Tom Koivisto,3,139,12,47,0,59,1,22,2,4,0,6,0,0,0,0,0,0
Tomas Kana,3,99,18,17,4,35,1,6,0,2,0,2,0,0,0,0,0,0
Tomi Maki,3,225,24,33,1,57,1,1,0,0,0,0,0,0,0,0,0,0
Tony Martensson,3,225,50,106,0,156,1,6,1,1,0,2,0,0,0,0,0,0
Tony Virta,3,145,37,57,1,94,1,8,2,3,0,5,0,0,0,0,0,0
Tyrone Garner,3,21,0,0,0,0,1,3,0,0,0,0,0,0,0,0,0,0
Viktor Tikhonov,3,82,14,30,0,44,1,61,8,8,0,16,0,0,0,0,0,0
Vladimir Vujtek,1,2,1,2,0,3,3,38,2,5,0,7,0,0,0,0,0,0
Vlastimil Kroupa,3,74,6,30,0,36,1,2,0,1,0,1,0,0,0,0,0,0
Alexander Kharitonov,1,2,1,0,0,1,2,71,7,15,0,22,0,0,0,0,0,0
Alexei Vasiliev,2,150,18,47,0,65,1,1,0,0,0,0,0,0,0,0,0,0
Andrew Miller,2,115,35,59,0,94,1,9,1,5,0,6,0,0,0,0,0,0
Barry Nieckar,2,142,21,20,29,41,1,1,0,0,0,0,0,0,0,0,0,0
Bill Berg,1,16,4,7,1,11,2,111,3,11,5,14,0,0,0,0,0,0
Brett Hauer,1,77,8,32,0,40,2,8,0,2,0,2,0,0,0,0,0,0
Bryan Rust,2,47,13,14,0,27,1,14,1,1,1,2,0,0,0,0,0,0
Chad Billins,2,141,20,59,0,79,1,10,0,3,0,3,0,0,0,0,0,0
Christian Dube,2,137,32,76,0,108,1,6,0,0,0,0,0,0,0,0,0,0
Christian Folin,1,13,2,2,0,4,2,41,2,9,1,11,0,0,0,0,0,0
Cole Jarrett,2,137,5,34,2,39,1,1,0,0,0,0,0,0,0,0,0,0
Connor Carrick,2,86,8,38,8,46,1,34,1,5,1,6,0,0,0,0,0,0
Connor Murphy,1,36,0,13,2,13,2,103,5,10,2,15,0,0,0,0,0,0
Corey Spring,1,57,19,25,14,44,2,16,1,1,2,2,0,0,0,0,0,0
Dan Kordic,1,9,1,1,3,2,2,63,1,1,18,2,0,0,0,0,0,0
Dana Murzyn,1,20,2,4,1,6,2,43,5,4,3,9,0,0,0,0,0,0
Dennis Vaske,1,43,2,13,0,15,2,22,0,3,0,3,0,0,0,0,0,0
Dmitry Korobov,2,136,6,42,3,48,1,3,0,1,0,1,0,0,0,0,0,0
Drew LeBlanc,2,117,11,17,0,28,1,2,0,0,0,0,0,0,0,0,0,0
Elias Lindholm,1,6,1,2,0,3,2,139,26,34,0,60,0,0,0,0,0,0
Emile Poirier,2,57,21,25,0,46,1,6,0,1,0,1,0,0,0,0,0,0
Erich Goldmann,2,84,1,5,1,6,1,1,0,0,0,0,0,0,0,0,0,0
Erik Andersson,2,34,5,9,1,14,1,12,2,1,0,3,0,0,0,0,0,0
Francois Groleau,2,126,21,50,0,71,1,1,0,0,0,0,0,0,0,0,0,0
Greg Andrusak,1,58,5,14,2,19,2,16,0,2,0,2,0,0,0,0,0,0
Greg Pankewicz,2,42,12,17,2,29,1,18,0,3,0,3,0,0,0,0,0,0
Hampus Lindholm,1,44,1,10,0,11,2,156,13,51,0,64,0,0,0,0,0,0
Hannes Hyvonen,1,67,24,18,0,42,2,42,4,5,0,9,0,0,0,0,0,0
Harri Pesonen,2,139,29,38,0,67,1,4,0,0,0,0,0,0,0,0,0,0
Jake McCabe,1,57,5,24,2,29,2,9,0,1,0,1,0,0,0,0,0,0
Jan Nemecek,1,65,7,24,0,31,2,7,1,0,0,1,0,0,0,0,0,0
Jeff Christian,2,7,1,1,0,2,1,1,0,0,0,0,0,0,0,0,0,0
Jeff Libby,2,13,0,3,0,3,1,1,0,0,0,0,0,0,0,0,0,0
Jeff Mitchell,2,84,7,6,8,13,1,7,0,0,1,0,0,0,0,0,0,0
Jeff Shevalier,2,71,23,32,0,55,1,5,0,0,0,0,0,0,0,0,0,0
Jesse Belanger,1,36,15,18,0,33,2,28,3,6,0,9,0,0,0,0,0,0
Joel Armia,2,108,19,41,1,60,1,1,0,0,0,0,0,0,0,0,0,0
John Klingberg,2,13,4,9,0,13,1,65,11,29,0,40,0,0,0,0,0,0
John Ramage,2,107,3,13,4,16,1,1,0,0,0,0,0,0,0,0,0,0
Jonas Ronnqvist,2,87,13,20,0,33,1,38,0,4,0,4,0,0,0,0,0,0
Joonas Rask,2,59,5,11,1,16,1,2,0,1,0,1,0,0,0,0,0,0
Jordan Oesterle,2,69,9,17,0,26,1,6,0,1,0,1,0,0,0,0,0,0
Josh Jooris,2,75,11,16,3,27,1,60,12,12,0,24,0,0,0,0,0,0
Josh Manson,2,45,4,9,6,13,1,28,0,3,1,3,0,0,0,0,0,0
Jussi Timonen,2,93,2,33,0,35,1,14,0,4,0,4,0,0,0,0,0,0
Jyrki Jokipakka,2,87,8,18,0,26,1,51,0,10,0,10,0,0,0,0,0,0
Lars Jonsson,2,84,9,24,0,33,1,8,0,2,0,2,0,0,0,0,0,0
Lee Sweatt,2,52,5,10,0,15,1,3,1,1,0,2,0,0,0,0,0,0
Lennart Petrell,1,9,2,2,0,4,2,95,7,11,2,18,0,0,0,0,0,0
Leo Komarov,1,14,6,3,2,9,2,104,12,23,0,35,0,0,0,0,0,0
Libor Pivko,2,136,23,78,0,101,1,1,0,0,0,0,0,0,0,0,0,0
Libor Zabransky,2,60,2,17,3,19,1,6,0,1,0,1,0,0,0,0,0,0
Luc Bourdon,1,41,6,8,2,14,2,36,2,0,1,2,0,0,0,0,0,0
Marc Rodgers,2,112,26,43,5,69,1,21,1,1,0,2,0,0,0,0,0,0
Marcel Mueller,2,129,28,51,4,79,1,3,0,0,0,0,0,0,0,0,0,0
Marko Dano,2,49,13,12,0,25,1,35,8,13,0,21,0,0,0,0,0,0
Matt Campanale,2,6,0,0,0,0,1,1,0,0,0,0,0,0,0,0,0,0
Matt Elich,1,22,2,2,0,4,2,16,1,1,0,2,0,0,0,0,0,0
Matt Koalska,2,125,27,37,0,64,1,3,0,0,0,0,0,0,0,0,0,0
Michael Raffl,1,2,1,2,0,3,2,135,30,20,2,50,0,0,0,0,0,0
Miikka Salomaki,2,113,27,41,0,68,1,1,1,0,0,1,0,0,0,0,0,0
Mike Connolly,2,118,22,38,1,60,1,2,0,0,0,0,0,0,0,0,0,0
Mike Hough,1,11,0,3,0,3,2,85,5,7,1,12,0,0,0,0,0,0
Nate Raduns,2,126,17,24,1,41,1,1,0,0,0,0,0,0,0,0,0,0
Nick Shore,2,106,34,46,0,80,1,34,1,6,0,7,0,0,0,0,0,0
Nikita Kucherov,1,17,13,11,0,24,2,134,37,45,0,82,0,0,0,0,0,0
Nikita Nesterov,2,86,7,23,1,30,1,27,3,4,0,7,0,0,0,0,0,0
Olli Malmivaara,2,117,9,19,1,28,1,2,0,0,0,0,0,0,0,0,0,0
Oscar Lindberg,2,150,46,54,0,100,1,1,0,0,0,0,0,0,0,0,0,0
Patrick Wey,2,31,1,5,0,6,1,9,0,3,1,3,0,0,0,0,0,0
Paul Comrie,2,19,3,4,0,7,1,15,1,2,0,3,0,0,0,0,0,0
Perttu Lindgren,2,143,24,57,0,81,1,1,0,0,0,0,0,0,0,0,0,0
Peter Zezel,1,35,13,37,0,50,2,71,11,23,0,34,0,0,0,0,0,0
Petr Hubacek,2,98,6,15,1,21,1,6,1,0,0,1,0,0,0,0,0,0
Petr Straka,2,128,23,28,1,51,1,3,0,2,0,2,0,0,0,0,0,0
Radoslav Hecl,2,116,12,28,2,40,1,14,0,0,0,0,0,0,0,0,0,0
Radovan Somik,1,1,0,0,0,0,2,113,12,20,1,32,0,0,0,0,0,0
Rasmus Ristolainen,1,34,6,14,0,20,2,112,10,14,0,24,0,0,0,0,0,0
Robb Gordon,2,108,20,28,9,48,1,4,0,0,0,0,0,0,0,0,0,0
Roman Simicek,1,49,12,14,0,26,2,63,7,10,1,17,0,0,0,0,0,0
Ryan Hartman,2,78,16,28,6,44,1,5,0,0,0,0,0,0,0,0,0,0
Ryan Huska,2,121,17,22,10,39,1,1,0,0,0,0,0,0,0,0,0,0
Ryan Mulhern,2,144,45,56,4,101,1,3,0,0,0,0,0,0,0,0,0,0
Ryan Savoia,2,61,9,26,0,35,1,3,0,0,0,0,0,0,0,0,0,0
Scott Daniels,1,13,1,5,8,6,2,27,0,3,16,3,0,0,0,0,0,0
Scott Harrington,2,124,7,29,1,36,1,10,0,0,0,0,0,0,0,0,0,0
Scott Levins,2,159,60,65,8,125,1,2,0,0,1,0,0,0,0,0,0,0
Scott Wilson,2,56,19,22,3,41,1,1,0,0,0,0,0,0,0,0,0,0
Seth Griffith,2,108,32,49,0,81,1,30,6,4,0,10,0,0,0,0,0,0
Shayne Gostisbehere,2,7,0,5,0,5,1,2,0,0,0,0,0,0,0,0,0,0
Stefan Noesen,2,29,7,9,1,16,1,1,0,0,0,0,0,0,0,0,0,0
Sven Andrighetto,2,124,31,56,0,87,1,12,2,1,0,3,0,0,0,0,0,0
Ted Crowley,2,137,18,62,2,80,1,13,1,2,0,3,0,0,0,0,0,0
Tim Schaller,2,137,26,35,4,61,1,18,1,1,0,2,0,0,0,0,0,0
Tim Sweeney,2,9,2,6,0,8,1,56,11,18,0,29,0,0,0,0,0,0
Tobias Rieder,2,73,32,21,0,53,1,72,13,8,0,21,0,0,0,0,0,0
Tom Wilson,1,2,0,0,0,0,2,149,7,20,26,27,0,0,0,0,0,0
Trent McCleary,1,27,7,9,2,16,2,58,1,0,1,1,0,0,0,0,0,0
Trevor Halverson,2,100,38,38,32,76,1,17,0,4,4,4,0,0,0,0,0,0
Tyler Gaudet,2,73,8,12,0,20,1,2,0,0,0,0,0,0,0,0,0,0
Tyler Graovac,2,137,34,37,1,71,1,3,0,0,0,0,0,0,0,0,0,0
Vaclav Pletka,2,132,40,40,0,80,1,1,0,0,0,0,0,0,0,0,0,0
Valery Nichushkin,1,5,0,4,0,4,2,87,14,21,0,35,0,0,0,0,0,0
William Karlsson,2,61,10,23,0,33,1,21,3,2,0,5,0,0,0,0,0,0
Zemgus Girgensons,1,61,6,11,0,17,2,131,23,29,1,52,0,0,0,0,0,0
Alexander Wennberg,1,6,0,3,0,3,1,68,4,16,0,20,0,0,0,0,0,0
Alexei Mikhnov,1,27,6,12,0,18,1,2,0,0,0,0,0,0,0,0,0,0
Andre Burakovsky,1,13,3,4,0,7,1,53,9,13,0,22,0,0,0,0,0,0
Andrei Zubarev,1,51,3,10,2,13,1,4,0,1,0,1,0,0,0,0,0,0
Andy Roach,1,9,2,3,0,5,1,5,1,2,0,3,0,0,0,0,0,0
Barclay Goodrow,1,7,2,4,1,6,1,60,4,8,1,12,0,0,0,0,0,0
Barry Potomski,1,75,9,7,13,16,1,9,0,1,4,1,0,0,0,0,0,0
Bill Arnold,1,61,15,23,0,38,1,1,0,0,0,0,0,0,0,0,0,0
Bjorn Melin,1,59,8,14,0,22,1,3,1,0,0,1,0,0,0,0,0,0
Bo Horvat,1,5,0,0,0,0,1,68,13,12,0,25,0,0,0,0,0,0
Bob Errey,1,69,18,27,1,45,1,71,2,9,1,11,0,0,0,0,0,0
Bogdan Yakimov,1,57,12,16,0,28,1,1,0,0,0,0,0,0,0,0,0,0
Borna Rendulic,1,26,4,4,0,8,1,11,1,1,0,2,0,0,0,0,0,0
Brady Murray,1,58,14,13,0,27,1,4,1,0,0,1,0,0,0,0,0,0
Brett Harkins,1,22,4,20,0,24,1,25,2,12,0,14,0,0,0,0,0,0
Brian Felsner,1,25,3,10,0,13,1,12,1,3,0,4,0,0,0,0,0,0
Brian Ferlin,1,53,11,9,0,20,1,7,0,1,0,1,0,0,0,0,0,0
Bryce Van Brabant,1,52,8,7,4,15,1,6,0,0,0,0,0,0,0,0,0,0
Chris Tierney,1,29,8,21,0,29,1,43,6,15,0,21,0,0,0,0,0,0
Christoph Brandner,1,37,7,7,0,14,1,35,4,5,0,9,0,0,0,0,0,0
Cody Kunyk,1,69,10,16,1,26,1,1,0,0,0,0,0,0,0,0,0,0
Dan Plante,1,70,11,15,4,26,1,7,0,1,0,1,0,0,0,0,0,0
Daniel Bang,1,53,9,13,0,22,1,8,0,2,0,2,0,0,0,0,0,0
Darnell Nurse,1,4,0,1,0,1,1,2,0,0,0,0,0,0,0,0,0,0
Darrin Shannon,1,8,2,0,0,2,1,58,2,12,0,14,0,0,0,0,0,0
David Emma,1,71,24,36,3,60,1,6,0,0,0,0,0,0,0,0,0,0
David Pastrnak,1,25,11,17,0,28,1,46,10,17,0,27,0,0,0,0,0,0
David Roberts,1,37,17,22,1,39,1,13,1,1,0,2,0,0,0,0,0,0
David Wolf,1,59,20,18,10,38,1,3,0,0,0,0,0,0,0,0,0,0
Dean Chynoweth,1,28,2,2,5,4,1,2,0,0,0,0,0,0,0,0,0,0
Dennis Everberg,1,12,5,2,0,7,1,55,3,9,0,12,0,0,0,0,0,0
Dody Wood,1,34,4,13,16,17,1,8,0,0,3,0,0,0,0,0,0,0
Esa Pirnes,1,4,3,1,0,4,1,57,3,8,0,11,0,0,0,0,0,0
Fredrik Lindquist-Bremberg,1,57,18,36,0,54,1,8,0,0,0,0,0,0,0,0,0,0
Iiro Pakarinen,1,39,17,11,0,28,1,17,1,2,0,3,0,0,0,0,0,0
Ilkka Heikkinen,1,72,8,30,1,38,1,7,0,0,0,0,0,0,0,0,0,0
Jacob de la Rose,1,37,6,5,0,11,1,33,4,2,0,6,0,0,0,0,0,0
Jan Benda,1,62,25,29,0,54,1,9,0,3,0,3,0,0,0,0,0,0
Jan Mertzig,1,35,3,2,0,5,1,23,0,2,0,2,0,0,0,0,0,0
Janne Niskala,1,80,19,25,1,44,1,6,1,2,0,3,0,0,0,0,0,0
Janne Pesonen,1,70,32,50,1,82,1,7,0,0,0,0,0,0,0,0,0,0
Jean-Yves Roy,1,65,28,34,0,62,1,2,0,0,0,0,0,0,0,0,0,0
Jeff Buchanan,1,38,4,6,10,10,1,6,0,0,1,0,0,0,0,0,0,0
Jeff Zehr,1,12,3,3,3,6,1,4,0,0,0,0,0,0,0,0,0,0
Jocelyn Lemieux,1,6,3,1,0,4,1,30,3,3,1,6,0,0,0,0,0,0
Joe Dziedzic,1,61,18,27,8,45,1,2,0,0,0,0,0,0,0,0,0,0
Johan Harju,1,63,23,30,0,53,1,10,1,2,0,3,0,0,0,0,0,0
Johan Lindbom,1,7,1,5,0,6,1,38,1,3,0,4,0,0,0,0,0,0
John Druce,1,39,21,28,1,49,1,23,1,2,0,3,0,0,0,0,0,0
Jonas Frogren,1,56,3,8,2,11,1,41,1,6,0,7,0,0,0,0,0,0
Jonas Holos,1,17,0,6,0,6,1,39,0,6,0,6,0,0,0,0,0,0
Jonas Nordqvist,1,65,15,26,1,41,1,3,0,2,0,2,0,0,0,0,0,0
Jori Lehtera,1,7,0,1,0,1,1,75,14,30,0,44,0,0,0,0,0,0
Josh Anderson,1,52,7,10,6,17,1,6,0,1,0,1,0,0,0,0,0,0
Jukka Hentunen,1,9,3,3,0,6,1,38,4,5,0,9,0,0,0,0,0,0
Kenny Agostino,1,67,15,28,2,43,1,8,1,1,0,2,0,0,0,0,0,0
Kerby Rychel,1,51,12,21,4,33,1,5,0,3,0,3,0,0,0,0,0,0
Kevin Czuczman,1,50,1,6,2,7,1,13,0,2,0,2,0,0,0,0,0,0
Kevin Fiala,1,33,11,9,0,20,1,1,0,0,0,0,0,0,0,0,0,0
Kirk Nielsen,1,72,19,29,0,48,1,6,0,0,0,0,0,0,0,0,0,0
Liam O'Brien,1,45,4,4,13,8,1,13,1,1,3,2,0,0,0,0,0,0
Linus Klasen,1,47,22,23,0,45,1,4,0,0,0,0,0,0,0,0,0,0
Marko Kiprusoff,1,9,0,2,0,2,1,27,0,6,0,6,0,0,0,0,0,0
Martin Strbak,1,12,0,1,0,1,1,49,5,11,0,16,0,0,0,0,0,0
Martti Jarventie,1,59,7,14,0,21,1,1,0,0,0,0,0,0,0,0,0,0
Matt Carey,1,67,10,11,1,21,1,2,1,0,0,1,0,0,0,0,0,0
Melker Karlsson,1,20,5,5,0,10,1,53,13,11,0,24,0,0,0,0,0,0
Mika Pyorala,1,35,8,10,0,18,1,36,2,2,0,4,0,0,0,0,0,0
Mike Stutzel,1,62,12,12,1,24,1,9,0,0,0,0,0,0,0,0,0,0
Mike Zalewski,1,55,3,9,0,12,1,2,0,1,0,1,0,0,0,0,0,0
Mikko Luoma,1,65,4,22,0,26,1,3,0,1,0,1,0,0,0,0,0,0
Mirco Mueller,1,9,0,2,0,2,1,39,1,3,0,4,0,0,0,0,0,0
Niklas Nordgren,1,7,5,3,0,8,1,58,4,2,0,6,0,0,0,0,0,0
Patrick Brown,1,60,2,8,2,10,1,7,0,0,0,0,0,0,0,0,0,0
Patrick Fischer,1,4,0,1,0,1,1,27,4,6,0,10,0,0,0,0,0,0
Per Gustafsson,1,25,7,17,0,24,1,31,1,5,0,6,0,0,0,0,0,0
Per Ledin,1,58,11,12,1,23,1,3,0,0,0,0,0,0,0,0,0,0
Peter Nordstrom,1,13,2,1,0,3,1,2,0,0,0,0,0,0,0,0,0,0
Petr Klima,1,15,2,6,0,8,1,13,1,0,0,1,0,0,0,0,0,0
Petteri Lindbohm,1,53,6,12,4,18,1,23,2,1,2,3,0,0,0,0,0,0
Pierre Hedin,1,62,5,19,0,24,1,3,0,1,0,1,0,0,0,0,0,0
Randy Burridge,1,6,0,1,1,1,1,30,4,6,0,10,0,0,0,0,0,0
Reto Von Arx,1,49,16,26,0,42,1,19,3,1,0,4,0,0,0,0,0,0
Rocco Grimaldi,1,64,14,28,1,42,1,7,1,0,0,1,0,0,0,0,0,0
Ronalds Kenins,1,36,5,7,1,12,1,30,4,8,0,12,0,0,0,0,0,0
Ronnie Sundin,1,67,3,19,1,22,1,1,0,0,0,0,0,0,0,0,0,0
Sergei Zinovjev,1,4,1,2,0,3,1,10,0,1,0,1,0,0,0,0,0,0
Simon Moser,1,48,8,18,0,26,1,6,1,1,0,2,0,0,0,0,0,0
Slater Koekkoek,1,72,5,21,0,26,1,3,0,0,0,0,0,0,0,0,0,0
Thomas Ziegler,1,3,0,1,1,1,1,5,0,0,0,0,0,0,0,0,0,0
Timo Parssinen,1,49,14,24,0,38,1,17,0,3,0,3,0,0,0,0,0,0
Todd Hlushko,1,33,10,14,2,24,1,13,0,1,1,1,0,0,0,0,0,0
Todd Krygier,1,6,3,4,0,7,1,45,2,12,0,14,0,0,0,0,0,0
Tomas Vlasak,1,5,0,1,0,1,1,10,1,3,0,4,0,0,0,0,0,0
Trevor van Riemsdyk,1,8,0,3,0,3,1,18,0,1,0,1,0,0,0,0,0,0
Tuomas Gronman,1,33,6,14,1,20,1,22,1,2,1,3,0,0,0,0,0,0
Viktor Arvidsson,1,70,22,33,0,55,1,6,0,0,0,0,0,0,0,0,0,0
