Player,AHL.Season,AHL.GP,AHL.Goals,AHL.Assists,AHL.Fights,AHL.Points,NHL.Season,NHL.GP,NHL.Goals,NHL.Assists,NHL.Fights,NHL.Points,WHL.Seasons,WHL.GP,WHL.Goals,WHL.Assists,WHL.Fights,WHL.Points
Zack Fitzgerald,9,447,11,38,117,49,1,1,0,0,0,0,4,248,22,54,46,76
Wade Skolney,5,310,6,33,45,39,1,1,0,0,0,0,5,172,10,44,19,54
Scott Jackson,4,240,2,30,17,32,1,1,0,0,0,0,6,329,23,96,8,119
Brodie Dupont,6,364,66,102,29,168,1,1,0,0,0,0,4,214,81,68,22,149
Curtis Hamilton,4,208,30,38,3,68,1,1,0,0,0,0,5,216,67,106,1,173
Kris Foucault,4,157,30,35,1,65,1,1,0,0,0,0,5,195,56,55,5,111
Layne Ulmer,5,311,65,87,0,152,1,1,0,0,0,0,4,261,161,154,5,315
Scott Glennie,5,230,46,72,1,118,1,1,0,0,0,0,4,252,121,187,8,308
Jeremy Yablonski,8,280,7,15,97,22,1,1,0,0,1,0,2,74,4,1,28,5
Duncan Siemens,3,103,1,9,8,10,1,1,0,0,0,0,4,188,14,78,19,92
Mitch Callahan,4,237,59,52,20,111,1,1,0,0,0,0,3,203,57,71,48,128
Brendan Ranford,2,138,30,54,0,84,1,1,0,0,0,0,5,278,115,155,6,270
Colin Smith,2,129,20,45,0,65,1,1,0,0,0,0,4,200,61,104,4,165
Masi Marjamaki,2,153,15,33,4,48,1,1,0,0,0,0,3,179,50,70,6,120
Milan Kytnar,2,91,14,18,1,32,1,1,0,0,0,0,3,172,50,76,4,126
Brett Kulak,3,36,5,11,1,16,1,1,0,0,0,0,2,72,9,15,0,24
Ivan Baranka,3,174,13,57,4,70,1,1,0,1,0,1,2,122,10,28,2,38
Stanislav Gron,3,202,48,34,2,82,1,1,0,0,0,0,2,110,37,47,1,84
Jonas Johansson,2,93,13,26,0,39,1,1,0,0,0,0,2,98,28,44,0,72
Greg Kuznik,4,207,8,14,11,22,1,1,0,0,0,0,1,72,5,12,14,17
Carter Bancks,6,281,21,45,21,66,1,2,0,0,0,0,5,262,58,120,15,178
Brett Lysak,5,226,35,44,5,79,1,2,0,0,0,0,4,265,134,175,8,309
Jesse Schultz,5,305,103,125,2,228,1,2,0,0,0,0,4,272,110,119,6,229
Mike Siklenka,8,229,20,33,32,53,2,2,0,0,0,0,2,69,19,13,5,32
Doug Lynch,3,161,12,29,12,41,1,2,0,0,0,0,5,266,55,87,40,142
Matt Konan,3,74,2,6,0,8,1,2,0,0,0,0,5,301,19,88,17,107
Riley Armstrong,7,334,78,70,4,148,1,2,0,0,0,0,2,134,24,36,2,60
Dominik Uher,3,193,24,33,16,57,1,2,0,0,0,0,3,181,58,86,14,144
Shay Stephenson,2,61,11,10,0,21,1,2,0,0,0,0,4,230,38,48,7,86
Keegan Lowe,2,121,4,19,16,23,1,2,0,0,2,0,3,212,7,54,24,61
Dmitri Yakushin,5,238,7,23,11,30,1,2,0,0,0,0,1,42,1,24,4,25
Greg Leeb,1,79,14,17,0,31,1,2,0,0,0,0,1,68,46,50,1,96
John Negrin,6,177,7,26,3,33,1,3,0,1,0,1,5,235,13,104,5,117
Grant McNeill,7,124,5,3,63,8,1,3,0,0,1,0,4,260,11,21,61,32
Dylan McIlrath,4,182,12,27,40,39,2,3,0,0,2,0,4,232,16,58,48,74
Ross Lupaschuk,4,278,49,73,27,122,1,3,0,0,0,0,4,267,63,104,30,167
Ryan Bonni,6,274,8,36,22,44,1,3,0,0,0,0,2,113,14,50,13,64
Garret Stroshein,4,140,2,7,47,9,1,3,0,0,2,0,1,11,0,0,5,0
Henrik Samuelsson,1,68,18,22,0,40,1,3,0,0,0,0,1,28,7,16,1,23
Jason MacDonald,7,364,59,68,92,127,1,4,0,0,1,0,6,184,14,18,2,32
Carsen Germyn,6,404,100,165,30,265,2,4,0,0,0,0,5,324,116,167,22,283
Brody Sutter,4,141,24,35,5,59,1,4,0,0,0,0,4,231,57,68,9,125
Owen Fussey,4,137,9,18,4,27,1,4,0,1,0,1,4,237,106,73,3,179
Dave Morisset,3,122,15,16,6,31,1,4,0,0,1,0,4,196,65,72,16,137
Mike Card,3,92,2,13,1,15,1,4,0,0,0,0,4,269,35,112,4,147
David Musil,2,126,4,19,2,23,1,4,0,2,0,2,3,192,19,65,8,84
Duncan Milroy,5,344,72,110,1,182,1,5,0,1,0,1,5,264,132,155,2,287
Jonathan Filewich,4,292,69,73,2,142,1,5,0,0,0,0,6,321,121,125,5,246
Brad Leeb,7,469,173,140,7,313,3,5,0,0,0,0,2,127,55,70,10,125
Patrick Holland,3,147,16,31,0,47,1,5,0,0,0,0,4,203,63,144,5,207
Josh Olson,6,241,41,35,6,76,1,5,1,0,0,1,2,144,62,86,10,148
Ryan Keller,5,284,102,98,2,200,1,6,0,0,0,0,4,257,120,117,4,237
Rasmus Rissanen,5,240,7,29,3,36,1,6,0,0,0,0,2,139,5,22,2,27
Mario Bliznak,3,214,31,40,0,71,2,6,1,0,0,1,3,183,36,58,1,94
Jaroslav Kristek,4,172,38,43,0,81,1,6,0,0,0,0,2,115,64,73,1,137
Landon Ferraro,5,270,75,65,10,140,2,7,1,0,0,1,5,220,76,76,17,152
Roman Wick,1,70,20,22,0,42,1,7,0,0,0,0,2,127,53,65,1,118
Ray Macias,5,178,18,47,0,65,2,8,0,1,0,1,5,280,66,118,0,184
Brad Moran,8,523,151,270,1,421,3,8,1,2,0,3,3,215,161,179,1,340
Jakub Cutta,5,298,9,34,9,43,3,8,0,0,0,0,3,177,10,23,4,33
Shaun Heshka,5,354,25,89,3,114,1,8,0,2,0,2,3,204,25,82,3,107
Jordan Martinook,3,182,38,54,6,92,1,8,0,1,0,1,2,144,51,41,7,92
Andrej Podkonicky,4,251,55,76,5,131,2,8,1,0,0,1,1,64,30,44,3,74
Griffin Reinhart,1,59,7,15,0,22,1,8,0,1,0,1,3,105,18,43,3,61
Mike Funk,4,151,4,23,3,27,2,9,0,2,0,2,4,280,23,98,8,121
Jame Pollock,7,330,69,128,2,197,1,9,0,0,0,0,2,125,21,68,0,89
Kirby Law,8,540,198,232,37,430,3,9,0,1,0,1,1,49,34,44,10,78
Roman Tvrdon,4,170,17,21,0,38,1,9,0,1,0,1,2,131,54,78,1,132
Sam Reinhart,1,3,0,3,0,3,1,9,0,1,0,1,2,71,30,34,0,64
Alex Plante,4,212,6,37,35,43,3,10,0,2,1,2,5,224,18,71,16,89
John Persson,4,177,44,30,3,74,1,10,1,0,0,1,3,200,63,67,1,130
Bryce Lampman,9,365,26,72,0,98,3,10,0,0,0,0,1,29,1,17,0,18
Barrett Heisten,4,250,38,43,11,81,1,10,0,0,0,0,1,58,20,57,3,77
Triston Grant,10,633,73,80,139,153,2,11,0,1,3,1,5,291,52,35,99,87
Kyle Rossiter,5,349,10,34,24,44,3,11,0,1,1,1,3,195,21,55,31,76
Petr Kalus,5,213,40,40,23,80,2,11,4,1,0,5,1,60,36,22,4,58
Nick Drazenovic,8,469,121,194,4,315,3,12,0,0,0,0,5,281,77,137,3,214
Brendan Shinnimin,3,190,47,61,6,108,1,12,0,1,0,1,5,266,131,206,9,337
Brandon Davidson,4,150,11,17,5,28,1,12,1,0,0,1,3,200,22,112,7,134
Dean Arsene,12,618,15,80,79,95,1,13,0,0,3,0,4,276,8,40,36,48
Ty Rattie,2,131,52,38,1,90,2,13,0,2,0,2,4,207,103,135,1,238
Dane Byers,10,564,128,177,95,305,3,14,1,0,4,1,4,236,49,50,39,99
Brett Bulmer,4,145,20,24,11,44,2,14,0,3,0,3,4,178,65,86,15,151
Ty Jones,3,158,21,36,40,57,2,14,0,0,3,0,2,106,54,76,25,130
Joe Morrow,3,155,14,46,2,60,1,15,1,0,0,1,5,227,33,118,14,151
Tyler Wotherspoon,2,109,3,30,0,33,2,15,0,4,0,4,4,178,10,35,4,45
Vladimir Mihalik,4,270,6,52,21,58,2,15,0,3,0,3,2,115,10,28,9,38
Cam Paddock,7,284,37,37,21,74,1,16,2,1,0,3,5,323,107,98,27,205
Carson McMillan,6,351,45,50,19,95,3,16,2,3,1,5,4,271,57,84,17,141
Jared Aulin,6,236,55,116,0,171,1,17,2,2,0,4,5,230,88,168,6,256
Tomas Mojzis,4,226,22,69,3,91,3,17,1,2,0,3,3,198,42,100,5,142
Filip Novak,4,245,33,110,6,143,2,17,0,0,0,0,3,171,36,128,11,164
Colton Sissons,2,138,50,36,1,86,1,17,1,3,0,4,2,121,43,39,4,82
Konstantin Pushkarev,4,234,47,72,3,119,2,17,2,3,0,5,1,69,22,30,2,52
Jozef Balej,5,227,55,89,2,144,2,18,1,5,0,6,3,176,105,85,1,190
Zach Hamill,7,349,66,126,1,192,3,20,0,4,0,4,5,250,87,175,1,262
Stefan Meyer,7,381,86,79,29,165,2,20,0,2,3,2,5,282,123,123,16,246
Shawn Belle,6,362,19,65,10,84,3,20,0,1,0,1,5,253,30,87,6,117
Mitch Fritz,11,322,11,21,85,32,1,20,0,0,6,0,2,110,13,2,51,15
Brandon Kozun,5,319,91,116,0,207,1,20,2,2,0,4,4,217,92,178,0,270
Richie Regehr,2,70,12,32,0,44,2,20,1,3,0,4,6,307,49,150,9,199
Brandon Manning,4,244,31,83,36,114,3,21,0,5,1,5,4,200,45,91,24,136
Darren Reid,5,203,41,41,17,82,2,21,0,1,2,1,3,167,55,87,38,142
Zenith Komarniski,7,415,56,104,21,160,3,21,1,1,0,2,1,46,7,24,5,31
Dustin Kohn,5,212,11,50,5,61,1,22,0,4,0,4,4,253,20,111,3,131
Jordan Krestanovich,4,258,44,80,1,124,2,22,0,2,0,2,4,226,66,97,0,163
Robert Schnabel,7,341,13,36,46,49,3,22,0,3,2,3,2,62,1,22,9,23
Micki DuPont,6,414,69,173,4,242,4,23,1,3,0,4,3,200,47,130,7,177
Max Reinhart,4,203,45,80,0,125,3,23,1,4,0,5,4,266,94,141,2,235
Kyle Freadrich,1,5,0,0,3,0,2,23,0,1,8,1,2,114,8,7,43,15
Colten Teubert,3,167,10,27,12,37,1,24,0,1,1,1,5,263,32,81,29,113
Spencer Machacek,6,415,117,155,20,272,3,25,2,7,1,9,3,203,77,91,10,168
Zdenek Blatny,6,331,66,89,8,155,3,25,3,0,0,3,3,170,102,107,4,209
Cody Almond,4,164,29,38,24,67,3,25,2,0,2,2,4,229,72,96,13,168
Nathan Smith,9,471,89,123,22,212,5,26,0,0,2,0,6,240,76,137,16,213
Ty Wishart,6,326,26,83,8,109,3,26,1,5,0,6,4,262,33,128,8,161
Steve Regier,4,288,76,102,2,178,4,26,3,1,0,4,4,193,37,49,12,86
Denis Tolpeko,2,82,19,28,2,47,1,26,1,5,0,6,3,179,46,65,3,111
Matt Keith,6,422,104,100,5,204,4,27,2,3,0,5,5,203,76,78,8,154
Tyler Pitlick,4,159,21,43,1,64,2,27,3,0,0,3,1,56,27,35,0,62
Ryan Hamilton,9,494,154,132,20,286,4,30,1,4,0,5,2,15,0,1,0,1
Tomas Kundratek,5,247,36,60,3,96,2,30,1,6,0,7,2,116,6,52,5,58
Boyd Kane,15,952,221,302,23,523,5,31,0,3,3,3,1,68,48,45,5,93
Jeremy Williams,7,328,138,124,4,262,5,32,9,2,0,11,4,174,99,108,1,207
Steve Gainey,6,355,60,90,32,150,4,33,0,2,2,2,2,136,51,68,12,119
Jay Henderson,7,387,86,102,71,188,3,33,1,3,3,4,1,72,49,45,10,94
Lynn Loyns,5,264,43,48,13,91,3,34,3,2,1,5,4,258,72,113,8,185
Quinton Howden,3,149,26,49,0,75,2,34,4,2,0,6,5,244,111,128,0,239
Alexander Urbom,4,225,5,49,5,54,4,34,3,1,2,4,1,66,12,21,1,33
Derrick Pouliot,1,31,7,17,0,24,1,34,2,5,0,7,3,145,16,74,5,90
Ryan Stone,5,309,60,130,28,190,3,35,0,7,5,7,4,239,78,162,23,240
Cam Severson,6,338,62,51,49,113,3,37,3,0,5,3,2,110,48,53,21,101
Aaron Gagnon,6,328,74,98,0,172,4,38,3,2,0,5,6,318,123,121,2,244
Justin Mapletoft,5,320,67,107,4,174,2,38,3,6,0,9,4,279,115,160,9,275
Michal Sivek,4,127,28,49,2,77,1,38,3,3,0,6,1,53,23,37,1,60
Burke Henry,6,375,24,111,31,135,2,39,2,6,3,8,2,140,36,123,20,159
Ryan Russell,6,336,70,61,2,131,1,41,2,0,0,2,4,263,98,118,8,216
Kenndal McArdle,6,250,47,44,20,91,4,42,1,2,7,3,5,261,92,111,23,203
Matt Ellison,4,256,64,93,8,157,3,43,3,11,1,14,1,72,40,56,0,96
Johnathan Aitken,7,410,8,42,44,50,2,44,0,1,8,1,1,69,9,25,11,34
Shane Endicott,6,354,67,106,1,173,2,45,1,2,1,3,4,219,72,101,1,173
Alex Petrovic,4,144,9,42,11,51,3,46,0,4,4,4,5,270,29,117,22,146
Ben Maxwell,5,301,68,140,1,208,4,47,2,6,1,8,5,210,64,95,5,159
Colby Robak,5,297,30,83,0,113,4,47,0,4,0,4,4,246,37,106,3,143
Jason Jaffray,13,560,179,270,24,449,4,49,4,7,5,11,5,277,107,128,18,235
Jesse Wallin,5,233,10,42,3,52,4,49,0,2,3,2,1,14,1,6,1,7
Lawrence Nycholat,10,557,73,260,31,333,4,50,2,7,0,9,3,213,51,137,18,188
Milan Bartovic,6,323,80,56,2,136,3,50,3,14,1,17,2,90,41,56,2,97
Damon Severson,1,2,0,2,0,2,1,51,5,12,0,17,3,125,11,43,3,54
Ben Ondrus,7,394,65,72,36,137,4,52,0,2,10,2,5,316,94,113,18,207
Chris Nielsen,5,306,40,64,3,104,2,52,6,8,0,14,3,200,82,84,1,166
Craig Cunningham,4,247,75,69,1,144,2,53,3,4,0,7,5,330,103,161,7,264
Mikhail Yakubov,4,182,22,31,0,53,2,53,2,10,0,12,1,71,32,57,0,89
Carter Ashton,5,192,56,47,9,103,3,54,0,3,4,3,5,239,92,89,16,181
Jeremy Colliton,6,325,77,125,4,202,5,57,3,3,0,6,4,229,71,105,5,176
Brett Sutter,8,538,91,139,27,230,7,60,2,8,4,10,4,254,58,80,12,138
Josh Holden,6,333,119,155,13,274,6,60,5,9,0,14,1,56,41,58,4,99
Stefan Elliott,4,199,43,52,0,95,4,63,6,12,0,18,5,282,82,159,2,241
Jim O'Brien,6,266,60,86,5,146,3,63,8,4,0,12,2,133,48,69,1,117
Martin Sonnenberg,8,476,126,150,7,276,3,63,2,3,1,5,1,72,40,52,2,92
Sergei Varlamov,6,398,122,178,1,300,4,63,8,7,0,15,1,72,66,53,2,119
Jakub Klepis,3,104,22,52,2,74,2,66,4,10,0,14,1,70,14,50,0,64
Steven Goertzen,7,382,46,58,34,104,4,68,2,2,12,4,3,206,33,46,18,79
Matthew Spiller,5,316,7,32,32,39,3,68,0,2,4,2,4,271,24,64,22,88
Sven Baertschi,3,124,38,57,0,95,4,69,10,20,0,30,2,113,67,112,0,179
Mark Pysyk,3,142,8,39,0,47,3,70,4,11,0,15,5,243,25,100,5,125
Matt Dumba,2,23,5,9,0,14,2,71,9,9,1,18,3,137,35,50,7,85
Michal Repik,4,243,66,116,2,182,4,72,9,11,0,20,3,176,75,93,4,168
Joey Tetarenko,8,415,24,64,113,88,4,73,4,1,19,5,1,49,2,12,14,14
Marian Cisar,1,2,1,0,0,1,3,73,13,17,0,30,1,52,33,40,2,73
Kyle Wanvig,7,394,114,131,49,245,5,75,6,9,4,15,4,266,107,98,29,205
Nolan Yonkman,14,725,21,79,75,100,7,76,1,9,7,10,4,255,12,26,21,38
Matt Kassian,7,231,10,12,69,22,4,76,4,1,23,5,4,245,17,19,66,36
Pavel Brendl,3,160,51,56,0,107,4,78,11,11,0,22,3,178,172,148,3,320
Quintin Laing,13,692,92,171,22,263,4,79,3,8,1,11,3,197,44,64,7,108
Adam Lowry,2,73,17,17,3,34,1,80,11,12,1,23,3,163,45,71,9,116
Victor Rask,2,86,17,27,0,44,1,80,11,22,0,33,1,64,33,30,0,63
Adam Cracknell,9,415,97,123,9,220,5,82,6,11,0,17,4,283,94,119,14,213
Roman Horak,3,139,41,48,0,89,3,84,6,13,0,19,2,130,47,78,1,125
Martin Marincin,5,128,10,35,0,45,2,85,1,10,0,11,2,125,25,71,1,96
Matt Fraser,4,181,90,41,5,131,4,87,11,6,3,17,5,265,87,87,37,174
Oscar Moller,3,110,40,48,0,88,3,87,12,14,0,26,2,131,71,81,0,152
Brett Festerling,5,241,9,51,6,60,4,88,0,8,1,8,6,314,15,54,1,69
Tomas Plihal,4,193,25,47,1,72,3,89,7,9,0,16,2,139,67,96,1,163
Brett Carson,7,321,25,102,0,127,5,90,2,11,0,13,5,268,28,82,1,110
Tyler Bouck,8,415,55,113,26,168,5,91,4,8,9,12,3,178,63,84,29,147
Steve MacIntyre,7,181,3,5,32,8,5,91,2,2,18,4,3,123,3,1,48,4
Linden Vey,3,191,55,103,0,158,2,93,10,19,0,29,5,262,102,178,1,280
Tomas Vincour,4,157,45,45,0,90,4,95,7,10,0,17,3,171,62,61,4,123
Craig Weller,6,300,32,51,31,83,2,95,4,10,12,14,2,99,6,18,15,24
Warren Peters,12,635,119,104,29,223,4,96,4,4,4,8,6,330,111,107,15,218
Mike Sauer,3,177,13,33,10,46,3,98,4,14,9,18,3,156,15,52,6,67
Kevin Connauton,4,221,33,55,10,88,2,98,10,19,1,29,1,69,24,48,7,72
Jeremy Reich,10,647,116,131,132,247,3,99,2,4,21,6,3,204,86,117,37,203
Colton Sceviour,5,348,99,141,8,240,4,99,17,22,1,39,5,251,78,114,10,192
Tyler Sloan,12,435,15,50,16,65,3,99,4,13,1,17,2,140,8,57,9,65
Paul Postma,4,215,47,89,0,136,5,100,7,11,0,18,5,270,44,117,0,161
Frazer McLaren,8,245,13,18,67,31,5,102,4,7,36,11,5,318,56,47,68,103
Brandon Segal,10,593,159,158,38,317,5,103,11,11,9,22,5,286,110,96,21,206
Mark Stone,2,91,30,49,0,79,3,103,30,42,0,72,4,232,106,190,4,296
Brayden McNabb,3,159,20,82,6,102,3,108,3,29,5,32,5,258,50,126,24,176
Jon Blum,6,336,42,137,2,179,5,110,7,17,0,24,4,248,49,155,3,204
Victor Bartley,4,148,18,49,1,67,3,111,1,22,3,23,6,336,36,132,15,168
Emerson Etem,4,119,51,41,0,92,3,112,15,16,1,31,3,202,143,109,2,252
Garth Murray,9,482,61,87,82,148,5,116,8,2,19,10,5,266,78,77,62,155
D.J. King,4,144,10,15,29,25,6,118,4,7,33,11,3,183,38,48,40,86
Ryan Stanton,4,224,9,51,14,60,3,119,4,23,3,27,5,242,19,83,15,102
Rick Rypien,4,108,15,22,20,37,6,119,9,7,29,16,4,179,47,67,31,114
Radko Gudas,3,206,15,42,42,57,3,126,7,25,10,32,1,65,7,30,9,37
Zach Boychuk,7,335,129,158,2,287,7,127,12,18,0,30,4,237,110,161,1,271
Stephen Peat,6,68,3,4,15,7,4,130,8,2,35,10,3,134,8,28,36,36
Brendan Mikkelson,8,329,35,92,8,127,5,131,1,9,3,10,4,226,16,54,9,70
Blair Jones,9,416,103,169,21,272,8,132,7,10,3,17,4,249,61,112,9,173
Jaroslav Svoboda,4,93,16,20,1,36,4,134,12,17,0,29,2,110,49,76,1,125
Dana Tyrell,6,232,47,71,2,118,5,135,7,17,0,24,5,240,81,98,6,179
Kyle Cumiskey,5,207,21,80,0,101,6,139,9,26,0,35,3,177,12,67,1,79
Nick Holden,6,295,26,92,3,118,4,139,15,24,0,39,2,137,30,61,1,91
Brett Connolly,2,137,52,68,1,120,4,139,18,16,2,34,4,144,86,66,0,152
Colin McDonald,7,449,110,127,17,237,5,140,18,26,3,44,2,3,0,0,0,0
David Koci,7,207,2,13,78,15,5,142,3,1,43,4,1,70,2,7,7,9
Derek Meech,8,377,36,129,0,165,6,144,4,13,1,17,5,263,27,70,4,97
James Wright,3,196,33,64,9,97,4,146,4,8,6,12,5,202,45,69,5,114
Justin Falk,4,228,7,26,10,33,6,147,2,17,12,19,4,191,7,44,9,51
Colton Gillies,5,282,33,56,12,89,4,154,6,12,2,18,4,195,44,47,7,91
Martin Cibak,4,177,15,39,0,54,3,154,5,18,0,23,2,124,37,55,0,92
Morgan Rielly,1,14,1,2,0,3,2,154,10,46,0,56,2,83,9,37,1,46
Riley Cote,5,128,4,5,45,9,4,156,1,6,53,7,4,235,54,67,27,121
Troy Bodie,8,381,56,54,75,110,5,159,9,12,26,21,4,250,64,65,38,129
Ole-Kristian Tollefsen,2,74,3,16,11,19,5,163,4,8,23,12,2,96,9,41,7,50
Nathan Paetsch,6,382,41,139,9,180,5,167,7,35,4,42,5,258,48,164,13,212
Keith Aulie,5,138,8,17,11,25,5,167,4,10,15,14,4,234,12,49,9,61
Brandon McMillan,4,160,35,40,2,75,5,171,14,22,0,36,4,250,55,113,4,168
Tyler Johnson,2,137,68,65,2,133,3,173,56,72,0,128,9,520,167,207,12,374
Shane Willis,8,317,115,136,1,251,5,174,31,43,0,74,1,64,58,54,0,112
Ryan White,5,190,36,47,27,83,6,175,11,18,23,29,8,499,104,196,22,300
Drayson Bowman,5,248,70,73,7,143,6,179,15,18,1,33,5,263,129,112,13,241
Rob Klinkhammer,6,396,82,129,8,211,5,179,21,21,2,42,4,230,57,67,10,124
Tyson Barrie,3,93,12,52,1,64,4,186,27,77,0,104,5,255,51,177,4,228
Trent Whitfield,15,808,256,344,4,600,8,194,11,18,6,29,1,65,38,44,1,82
Rick Berry,7,383,25,74,36,99,4,197,2,13,22,15,1,59,9,21,6,30
Ryan Craig,9,500,125,152,32,277,8,198,32,31,14,63,6,302,137,131,15,268
Kris Beech,5,226,89,122,0,211,7,198,25,42,0,67,4,232,90,164,1,254
Lance Bouma,3,95,16,11,8,27,4,199,22,31,7,53,5,230,39,76,18,115
Mike Wilson,8,290,22,49,14,71,6,201,10,24,5,34,5,175,19,79,1,98
Thomas Hickey,5,212,14,61,2,75,3,202,7,41,0,48,5,262,39,137,4,176
Michael Stone,3,157,17,46,1,63,4,204,17,34,0,51,4,264,52,129,6,181
Milan Kraft,4,128,51,75,3,126,4,207,41,41,0,82,2,124,74,81,0,155
Brendan Gallagher,1,36,10,10,3,20,3,207,58,58,4,116,4,244,136,144,11,280
Brenden Dillon,3,123,9,34,8,43,4,209,11,24,13,35,4,280,11,83,22,94
Matt Calvert,3,128,40,42,7,82,5,209,42,44,10,86,3,198,99,131,11,230
Lance Ward,5,243,12,44,22,56,4,209,4,12,29,16,1,71,8,25,12,33
Nigel Dawes,5,232,117,116,4,233,5,212,39,45,2,84,4,245,159,113,3,272
Keaton Ellerby,4,191,14,49,0,63,6,212,4,23,3,27,4,266,6,54,19,60
Jared Cowen,1,3,0,3,0,3,5,212,15,27,8,42,5,239,37,82,12,119
Dustin Boyd,4,136,51,49,0,100,5,220,32,31,1,63,4,265,103,114,6,217
Nino Niederreiter,2,80,31,23,0,54,4,225,40,36,0,76,2,120,77,53,2,130
Aaron Rome,7,260,31,83,17,114,8,226,6,22,9,28,6,304,31,124,27,155
Ryan Hollweg,6,202,18,22,29,40,5,228,5,9,27,14,5,233,94,139,16,233
David Schlemko,5,129,13,51,0,64,7,231,9,41,0,50,3,198,22,109,3,131
Cody Eakin,3,82,27,26,0,53,4,237,46,61,1,107,5,238,118,121,6,239
Marcel Hossa,5,186,74,63,0,137,6,237,31,30,0,61,3,188,65,99,0,164
Dwight King,4,202,50,74,9,124,5,238,37,43,2,80,5,273,79,110,9,189
Nick Tarnasky,6,315,54,45,68,99,5,245,13,17,39,30,3,150,36,43,15,79
Brad Ference,5,277,14,69,30,83,6,250,4,30,35,34,2,105,18,66,20,84
Dale Weise,3,194,57,54,19,111,5,258,23,36,25,59,3,173,51,61,17,112
Ryan Nugent-Hopkins,1,19,8,12,0,20,4,258,65,123,1,188,3,141,57,120,1,177
Ryan Johansen,1,40,17,16,0,33,4,271,73,94,1,167,2,134,65,96,1,161
Brayden Schenn,3,47,22,30,1,52,6,274,58,76,11,134,4,224,116,199,11,315
Ryan Reaves,4,214,20,25,47,45,5,275,17,17,48,34,3,201,36,43,7,79
Derek Boogaard,1,53,0,4,24,4,6,277,3,13,62,16,4,174,3,18,70,21
Jeff Woywitka,7,274,16,96,8,112,7,278,9,46,5,55,4,268,41,99,13,140
Joel Kwiatkowski,6,276,45,93,0,138,7,282,16,29,0,45,1,62,21,43,1,64
Jamie Lundmark,8,298,89,133,10,222,6,295,40,59,9,99,3,159,96,120,9,216
Jared Spurgeon,1,23,2,7,0,9,5,295,26,75,0,101,5,264,37,132,1,169
Clayton Stoner,5,283,15,65,29,80,6,296,5,34,36,39,3,189,23,70,12,93
Mikael Backlund,2,55,15,17,0,32,7,298,51,77,2,128,1,28,12,18,0,30
Gilbert Brule,4,93,33,31,6,64,8,299,43,52,4,95,4,165,87,98,8,185
Steve McCarthy,7,193,14,53,1,67,8,302,17,38,4,55,3,152,43,85,9,128
Ryan Shannon,5,186,41,109,2,150,6,305,35,64,0,99,2,138,5,30,21,35
Scott Parker,2,100,16,10,37,26,8,308,7,14,75,21,1,71,30,22,16,52
Cam Barker,4,93,19,28,7,47,8,310,21,75,11,96,5,213,51,128,11,179
Matt Walker,8,240,9,43,31,52,9,314,4,26,54,30,3,197,9,49,37,58
Michael Grabner,4,180,68,52,0,120,6,317,95,60,0,155,3,180,88,41,0,129
Deryk Engelland,6,339,14,42,63,56,6,319,15,43,45,58,5,243,14,34,60,48
Zack Smith,4,171,46,57,22,103,7,319,39,39,27,78,4,221,41,68,26,109
T.J. Galiardi,2,67,10,18,0,28,7,321,44,61,2,105,1,72,18,52,3,70
Travis Hamonic,2,40,6,11,7,17,5,323,18,93,12,111,4,181,29,80,14,109
Mark Fistric,5,182,4,40,4,44,8,325,4,30,12,34,5,214,11,47,21,58
Oleg Saprykin,3,94,29,37,2,66,7,325,55,82,2,137,2,114,77,82,3,159
Eric Godard,8,297,11,13,98,24,8,335,6,12,97,18,3,133,5,10,79,15
Josh Green,10,368,102,146,7,248,9,341,36,40,8,76,1,31,35,19,2,54
Luca Sbisa,3,14,3,10,0,13,7,342,12,55,13,67,3,109,14,52,7,66
Ronald Petrovicky,4,155,35,54,16,89,6,342,41,51,27,92,1,71,64,49,17,113
Marek Svatos,2,60,18,8,0,26,7,344,100,72,1,172,2,92,61,57,0,118
Tyler Ennis,1,69,23,42,0,65,6,345,89,123,1,212,4,245,115,121,2,236
Josef Melichar,3,152,6,18,9,24,7,349,7,42,6,49,2,132,17,52,6,69
Jordan Eberle,3,54,34,40,0,74,5,356,120,164,0,284,4,254,155,155,0,310
Kurt Sauer,1,4,0,0,0,0,7,357,5,28,11,33,3,180,12,42,8,54
Colin Fraser,5,286,53,72,42,125,9,359,20,38,31,58,4,269,74,140,59,214
Darren Helm,3,124,29,39,0,68,8,366,59,77,0,136,3,201,76,91,3,167
Mark Smith,4,165,41,73,11,114,7,377,23,47,33,70,1,70,42,67,13,109
Mike Brown,9,457,55,67,132,122,12,383,18,16,106,34,7,312,66,63,71,129
Brett McLean,7,351,95,140,0,235,6,385,56,106,2,162,2,119,89,100,1,189
Erik Christensen,4,75,40,35,0,75,7,387,68,95,0,163,5,338,133,153,0,286
Johnny Boychuk,5,294,45,108,20,153,8,393,28,82,10,110,5,266,38,95,21,133
Cody Franson,3,158,24,71,1,95,6,400,35,134,0,169,5,199,34,85,5,119
Garnet Exelby,7,457,21,65,61,86,7,408,7,43,30,50,3,189,13,29,17,42
Jeff Schultz,4,164,7,34,1,41,8,408,11,65,1,76,4,262,22,85,1,107
Derek Dorsett,2,71,11,13,29,24,7,410,38,60,89,98,3,180,49,79,42,128
Kyle Chipchura,5,186,41,63,14,104,8,412,27,65,43,92,5,216,59,106,15,165
Ryan Carter,2,89,19,22,7,41,8,413,34,47,30,81,1,15,0,1,1,1
Matt Pettinger,6,267,67,62,14,129,9,422,65,58,10,123,1,27,14,6,3,20
Karl Alzner,2,104,7,34,0,41,7,427,12,71,1,83,5,260,19,98,2,117
Ben Clymer,1,50,11,16,4,27,7,438,52,77,25,129,1,70,12,44,5,56
Eric Fehr,3,120,50,51,2,101,10,454,89,88,0,177,5,279,146,131,3,277
Brian Sutherby,6,58,4,18,7,22,9,460,41,49,49,90,4,208,79,99,21,178
Jim Vandermeer,5,230,15,40,28,55,9,461,25,80,45,105,4,248,34,100,53,134
Jannik Hansen,4,129,34,46,1,80,8,470,77,107,5,184,1,64,24,40,5,64
Nate Thompson,3,216,35,45,21,80,8,471,44,59,16,103,4,253,55,88,6,143
Devin Setoguchi,2,42,11,18,1,29,8,471,127,122,4,249,4,255,118,125,10,243
Kris Versteeg,3,139,46,81,10,127,8,473,116,159,9,275,4,264,62,105,9,167
Colby Armstrong,4,243,34,55,8,89,8,476,89,120,13,209,4,205,76,109,10,185
Colton Orr,5,106,2,4,42,6,11,477,12,12,123,24,5,164,19,9,54,28
Blair Betts,4,180,45,58,0,103,9,477,41,37,0,78,3,157,79,98,2,177
Shaone Morrisonn,4,216,15,49,8,64,8,480,11,64,6,75,3,179,25,57,6,82
Roman Polak,2,87,4,15,2,19,9,480,18,70,13,88,1,65,5,18,1,23
Blake Comeau,3,111,20,61,4,81,9,483,88,107,4,195,5,253,60,117,13,177
Fredrik Sjostrom,3,21,2,7,0,9,7,489,46,58,1,104,2,121,53,74,0,127
Brandon Sutter,3,36,6,12,0,18,7,495,98,87,6,185,4,205,68,86,4,154
Trent Hunter,5,297,112,140,4,252,9,497,101,135,2,236,3,177,77,83,4,160
Ian White,3,108,12,52,1,64,8,503,45,134,5,179,4,246,77,145,1,222
Kris Russell,1,14,3,5,0,8,8,511,34,124,8,158,4,241,76,120,6,196
Troy Brouwer,3,146,78,63,11,141,9,531,132,123,25,255,5,287,103,116,15,219
Darcy Hordichuk,4,100,7,11,19,18,12,542,20,21,137,41,2,129,9,10,65,19
Clarke MacArthur,3,163,56,102,4,158,9,544,133,171,4,304,3,190,88,136,8,224
Todd Fedoruk,4,42,1,6,16,7,9,545,32,65,103,97,2,119,25,24,35,49
Brandon Dubinsky,1,71,21,22,8,43,9,545,112,207,38,319,4,234,82,148,25,230
Cody McLeod,3,132,21,19,34,40,8,549,57,46,109,103,4,257,69,68,53,137
Scottie Upshall,5,62,32,28,1,60,12,553,115,119,5,234,3,173,99,127,2,226
Alex Edler,2,51,5,22,0,27,9,568,66,193,0,259,1,62,13,40,0,53
Tomas Kopecky,6,268,73,89,4,162,10,578,68,106,3,174,2,109,56,70,2,126
Tomas Fleischmann,3,104,52,63,0,115,10,581,123,187,1,310,2,125,54,92,0,146
Kyle Calder,2,77,26,31,1,57,10,590,114,180,4,294,2,123,69,96,2,165
Dustin Byfuglien,3,123,26,48,7,74,10,597,133,211,12,344,4,189,48,94,12,142
Mike Green,8,342,88,149,1,237,11,599,114,250,2,364,8,478,130,255,11,385
Chuck Kobasew,3,108,53,26,4,79,11,601,110,100,15,210,1,55,41,21,2,62
Jerred Smithson,7,303,23,78,2,101,11,606,39,57,8,96,3,194,40,56,14,96
Josh Gorges,2,25,2,4,0,6,10,606,14,90,7,104,4,245,33,119,7,152
Jordin Tootoo,2,92,19,26,15,45,11,607,59,90,88,149,4,220,93,116,51,209
Braydon Coburn,2,88,7,30,7,37,10,618,37,131,10,168,5,238,29,102,18,131
Kyle Brodziak,2,117,36,51,1,87,10,621,98,130,12,228,5,273,81,104,16,185
Boyd Gordon,3,103,21,41,0,62,11,628,53,103,1,156,4,260,77,130,4,207
Joffrey Lupul,2,6,4,5,0,9,11,655,194,212,10,406,3,191,127,113,2,240
Paul Gaustad,3,238,37,100,29,137,11,664,87,138,46,225,3,198,53,82,28,135
Brooks Laich,2,75,22,27,0,49,11,683,132,185,5,317,3,206,78,124,1,202
Shea Weber,1,45,12,15,3,27,10,685,146,246,20,392,4,190,26,65,18,91
Andrew Ladd,2,27,12,8,2,20,10,691,185,235,16,420,3,137,49,71,12,120
Ryan Johnson,3,102,27,67,0,94,13,701,38,84,2,122,1,2,0,0,0,0
Ryan Getzlaf,1,17,8,25,0,33,10,710,208,470,23,678,4,233,95,120,11,215
Mark Parrish,6,169,52,71,0,123,12,722,216,171,4,387,1,54,54,38,1,92
Travis Moen,2,84,2,4,12,6,11,724,59,75,76,134,4,181,27,31,30,58
Vernon Fiddler,5,204,34,57,6,91,12,736,90,145,17,235,4,267,85,100,11,185
Duncan Keith,1,75,7,18,0,25,10,766,75,340,6,415,1,37,11,35,2,46
Arron Asham,6,139,40,49,16,89,15,789,94,114,102,208,1,67,43,49,13,92
Jarret Stoll,2,152,42,66,0,108,12,792,140,239,0,379,5,245,124,162,0,286
Barret Jackman,2,76,2,12,23,14,13,803,28,153,55,181,4,234,28,111,57,139
Dan Hamhuis,2,136,12,42,2,54,11,814,52,238,9,290,4,247,34,122,13,156
Jason Chimera,4,237,70,89,11,159,14,869,143,186,33,329,2,130,66,66,6,132
Martin Erat,2,90,20,44,0,64,13,881,176,369,0,545,2,114,50,85,1,135
Michal Rozsival,3,79,11,30,2,41,14,890,66,227,3,293,1,71,14,55,2,69
Andrew Ference,4,89,14,38,4,52,15,901,43,182,31,225,2,112,22,78,5,100
Jay Bouwmeester,1,2,0,1,0,1,12,918,78,279,1,357,4,194,40,111,0,151
Cory Sarich,3,94,3,32,4,35,15,969,21,137,45,158,1,46,8,40,5,48
Eric Brewer,1,25,2,2,2,4,16,1009,77,194,21,271,1,34,5,28,3,33
Scott Hannan,2,43,5,12,2,17,16,1055,38,179,9,217,2,94,25,60,2,85
Robyn Regehr,1,5,0,0,0,0,15,1089,36,163,40,199,2,119,16,30,10,46
Patrick Wellar,9,304,8,42,65,50,0,0,0,0,0,0,5,247,16,42,35,58
Brennan Evans,11,783,19,102,127,121,0,0,0,0,0,0,4,257,12,29,28,41
Derek Couture,7,301,39,42,41,81,0,0,0,0,0,0,5,254,48,58,36,106
Garrett Bembridge,8,306,44,49,0,93,0,0,0,0,0,0,4,218,89,99,3,188
Ashton Rome,6,294,40,38,13,78,0,0,0,0,0,0,5,319,72,102,16,174
Brett Palin,6,367,10,51,17,61,0,0,0,0,0,0,5,324,6,55,26,61
Garrett Mitchell,6,224,25,30,27,55,0,0,0,0,0,0,5,264,51,61,41,112
Joel Broda,5,202,31,25,11,56,0,0,0,0,0,0,6,330,141,120,11,261
Kyle Beach,6,208,43,40,26,83,0,0,0,0,0,0,5,251,134,139,44,273
Mitch Love,5,278,6,21,106,27,0,0,0,0,0,0,6,320,33,66,87,99
Shane Harper,6,281,65,59,3,124,0,0,0,0,0,0,5,335,100,114,3,214
Travis Ehrhardt,6,187,9,26,3,35,0,0,0,0,0,0,5,256,20,99,8,119
Wacey Rabbit,5,309,36,59,9,95,0,0,0,0,0,0,6,289,91,131,11,222
Dylan Yeo,7,162,10,38,4,48,0,0,0,0,0,0,4,228,21,52,9,73
Jordan Henry,7,306,22,47,10,69,0,0,0,0,0,0,4,270,12,61,21,73
Sean Zimmerman,7,274,5,26,10,31,0,0,0,0,0,0,4,270,10,49,2,59
Chris Collins,5,192,38,43,4,81,0,0,0,0,0,0,5,200,37,71,2,108
Jordan Weal,5,221,58,115,0,173,0,0,0,0,0,0,5,282,135,250,1,385
Justin Dowling,5,207,54,79,0,133,0,0,0,0,0,0,5,280,81,160,1,241
Logan Pyett,5,362,30,102,2,132,0,0,0,0,0,0,5,273,49,137,6,186
Mitch Wahl,5,71,6,13,0,19,0,0,0,0,0,0,5,271,97,186,12,283
Phil Cole,5,58,1,3,9,4,0,0,0,0,0,0,5,219,13,41,37,54
Scott Kelman,5,74,12,22,5,34,0,0,0,0,0,0,5,332,99,187,11,286
Sena Acolatse,5,195,23,55,21,78,0,0,0,0,0,0,5,322,45,109,49,154
Simon Ferguson,5,324,31,52,55,83,0,0,0,0,0,0,5,319,61,100,27,161
Tyler Shattock,5,258,20,42,7,62,0,0,0,0,0,0,5,248,76,119,15,195
Tyler Spurgeon,5,148,14,37,2,51,0,0,0,0,0,0,5,212,43,81,4,124
Adrian Foster,8,163,35,40,0,75,0,0,0,0,0,0,3,39,15,20,0,35
Brady Calla,4,64,5,10,1,15,0,0,0,0,0,0,6,319,62,111,15,173
Brent Regner,6,388,24,118,3,142,0,0,0,0,0,0,4,207,24,96,4,120
Cam Cunning,6,342,65,54,14,119,0,0,0,0,0,0,4,245,57,54,16,111
Dan DaSilva,8,383,91,114,18,205,0,0,0,0,0,0,3,200,76,75,15,151
Jeff May,4,143,4,17,4,21,0,0,0,0,0,0,6,310,19,124,14,143
Justin Keller,4,256,63,59,4,122,0,0,0,0,0,0,6,322,128,98,2,226
Matt Kinch,6,315,25,88,0,113,0,0,0,0,0,0,4,255,53,220,1,273
Riley Holzapfel,6,335,69,101,1,170,0,0,0,0,0,0,4,248,91,117,2,208
Tim Wedderburn,6,297,6,33,2,39,0,0,0,0,0,0,4,273,20,76,9,96
Adam Hobson,4,99,8,18,8,26,0,0,0,0,0,0,5,252,51,77,6,128
Blake Evans,5,344,65,89,0,154,0,0,0,0,0,0,4,284,116,156,13,272
Brandin Cote,4,189,13,27,4,40,0,0,0,0,0,0,5,345,101,154,12,255
Brett Draney,4,66,4,5,7,9,0,0,0,0,0,0,5,270,65,104,10,169
Brett Ponich,4,134,0,12,20,12,0,0,0,0,0,0,5,249,2,45,22,47
Brett Scheffelmaier,4,133,0,6,38,6,0,0,0,0,0,0,5,273,11,36,93,47
Brett Sonne,4,271,32,36,9,68,0,0,0,0,0,0,5,232,89,82,7,171
C.J. Stretch,4,179,28,52,0,80,0,0,0,0,0,0,5,341,85,163,3,248
Chris Chartier,5,263,16,68,0,84,0,0,0,0,0,0,4,261,40,141,4,181
Chris Langkow,4,148,15,29,1,44,0,0,0,0,0,0,5,263,53,101,3,154
Craig Valette,5,270,30,40,15,70,0,0,0,0,0,0,4,248,50,47,11,97
J.D. Watt,4,168,12,12,46,24,0,0,0,0,0,0,5,255,62,79,47,141
Jason Goulet,5,126,21,25,2,46,0,0,0,0,0,0,4,102,1,6,19,7
John Lammers,4,156,27,35,1,62,0,0,0,0,0,0,5,256,93,106,5,199
Jordan Knackstedt,5,210,38,54,14,92,0,0,0,0,0,0,4,268,67,117,16,184
Justin Cox,5,291,28,43,2,71,0,0,0,0,0,0,4,254,73,93,3,166
Logan Stephenson,5,312,9,27,24,36,0,0,0,0,0,0,4,249,19,66,24,85
Mark Louis,4,181,1,14,39,15,0,0,0,0,0,0,5,303,10,40,27,50
Nathan Barrett,4,265,65,96,0,161,0,0,0,0,0,0,5,316,157,172,7,329
Ned Lukacevic,4,112,10,17,1,27,0,0,0,0,0,0,5,238,63,74,7,137
Nick Ross,4,115,6,21,1,27,0,0,0,0,0,0,5,288,33,112,12,145
Ryan Jorde,4,162,0,5,27,5,0,0,0,0,0,0,5,216,4,29,55,33
Taylor Vause,4,125,14,28,0,42,0,0,0,0,0,0,5,273,79,111,1,190
Tom Maxwell,5,155,7,14,56,21,0,0,0,0,0,0,4,244,33,40,43,73
Tyler Beechey,4,58,17,20,1,37,0,0,0,0,0,0,5,262,103,132,2,235
Ajay Baines,9,651,103,149,18,252,0,0,0,0,0,0,2,144,67,57,11,124
Craig Schira,3,208,15,32,5,47,0,0,0,0,0,0,6,340,33,124,10,157
David Schulz,3,15,0,2,1,2,0,0,0,0,0,0,6,304,23,73,10,96
Dustin Sylvester,3,129,26,31,0,57,0,0,0,0,0,0,6,308,111,141,4,252
J.J. Hunter,6,152,27,30,7,57,0,0,0,0,0,0,3,202,69,80,4,149
Jason Beckett,6,297,13,41,40,54,0,0,0,0,0,0,3,211,8,52,34,60
Jonathan Parker,3,76,6,6,1,12,0,0,0,0,0,0,6,317,86,88,8,174
Kiel McLeod,3,159,14,22,9,36,0,0,0,0,0,0,6,290,123,138,22,261
Lance Monych,3,45,0,0,0,0,0,0,0,0,0,0,6,319,110,126,22,236
Ryan Kinasewich,3,42,6,5,0,11,0,0,0,0,0,0,6,298,106,146,6,252
Andy Rogers,4,119,0,10,3,10,0,0,0,0,0,0,4,158,3,18,6,21
Benn Olson,4,81,1,7,34,8,0,0,0,0,0,0,4,244,3,26,59,29
Chris Bruton,4,200,10,13,55,23,0,0,0,0,0,0,4,258,58,80,28,138
Curt Gogol,4,172,15,9,54,24,0,0,0,0,0,0,4,168,7,19,45,26
Darcy Robinson,4,193,4,25,20,29,0,0,0,0,0,0,4,240,12,28,22,40
Daryl Boyle,4,174,11,38,3,49,0,0,0,0,0,0,4,262,31,100,9,131
Greg Scott,4,270,54,84,9,138,0,0,0,0,0,0,4,278,96,109,10,205
Ian Schultz,4,121,9,20,22,29,0,0,0,0,0,0,4,196,55,72,48,127
Jeff Smith,4,28,2,0,4,2,0,0,0,0,0,0,4,229,40,32,48,72
Levi Nelson,4,138,17,14,2,31,0,0,0,0,0,0,4,198,65,87,6,152
Mark McNeill,4,151,41,40,4,81,0,0,0,0,0,0,4,211,72,104,8,176
Matt MacKenzie,4,161,4,20,9,24,0,0,0,0,0,0,4,225,18,80,6,98
Paul Elliott,4,199,10,25,0,35,0,0,0,0,0,0,4,276,55,141,7,196
Randall Gelech,4,285,42,46,4,88,0,0,0,0,0,0,4,237,62,50,12,112
Sam Klassen,4,137,2,10,3,12,0,0,0,0,0,0,4,249,7,74,10,81
Sean Curry,8,499,32,69,50,101,0,0,0,0,0,0,2,132,15,31,9,46
Sean McAslan,4,65,12,15,3,27,0,0,0,0,0,0,4,263,54,80,22,134
Shaun Sutter,4,62,14,10,0,24,0,0,0,0,0,0,4,225,58,61,16,119
Wacey Hamilton,4,216,18,36,3,54,0,0,0,0,0,0,4,234,61,132,13,193
Aaron Boogaard,3,64,3,1,30,4,0,0,0,0,0,0,5,273,26,28,57,54
Brad Ross,3,125,18,11,7,29,0,0,0,0,0,0,5,270,109,136,34,245
Brad Schell,3,22,3,4,0,7,0,0,0,0,0,0,5,239,70,112,1,182
Codey Burki,3,102,11,17,0,28,0,0,0,0,0,0,5,263,74,107,5,181
Darian Dziurzynski,3,181,26,17,26,43,0,0,0,0,0,0,5,304,92,69,44,161
Darrell Hay,5,153,12,30,3,42,0,0,0,0,0,0,3,207,33,118,6,151
Eric Hunter,3,89,7,10,1,17,0,0,0,0,0,0,5,323,111,122,11,233
Eric Johansson,3,195,21,37,0,58,0,0,0,0,0,0,5,263,112,154,2,266
Garrett Klotz,5,157,4,7,30,11,0,0,0,0,0,0,3,150,5,5,35,10
"George ""Bud"" Holloway",3,191,54,66,4,120,0,0,0,0,0,0,5,282,95,102,6,197
Gord Baldwin,5,263,8,45,14,53,0,0,0,0,0,0,3,190,14,47,16,61
Graham Belak,5,140,1,4,48,5,0,0,0,0,0,0,3,141,12,15,58,27
Ian McKenzie,3,52,4,1,4,5,0,0,0,0,0,0,5,228,39,37,17,76
James Martin,3,35,2,2,2,4,0,0,0,0,0,0,5,190,19,33,8,52
Justin Taylor,5,165,31,36,3,67,0,0,0,0,0,0,3,116,18,29,7,47
K.C. Timmons,5,107,10,19,17,29,0,0,0,0,0,0,3,210,48,42,48,90
Kevin Sundher,3,129,11,27,3,38,0,0,0,0,0,0,5,273,94,158,5,252
Mark Ardelan,3,201,24,71,1,95,0,0,0,0,0,0,5,338,46,148,13,194
Mark Rooneem,3,12,2,0,0,2,0,0,0,0,0,0,5,304,62,72,6,134
Paul Albers,3,147,9,23,2,32,0,0,0,0,0,0,5,329,31,112,2,143
Scott Balan,3,53,0,1,3,1,0,0,0,0,0,0,5,228,7,40,20,47
Shayne Wiebe,3,38,1,6,0,7,0,0,0,0,0,0,5,276,108,89,8,197
Taylor Ellington,3,21,2,3,1,5,0,0,0,0,0,0,5,287,14,52,22,66
Tyler Mosienko,3,53,8,12,0,20,0,0,0,0,0,0,5,338,81,151,6,232
Willie Coetzee,5,135,21,33,1,54,0,0,0,0,0,0,3,167,49,76,1,125
Brent Henley,7,91,0,9,32,9,0,0,0,0,0,0,2,36,0,6,5,6
Chad Hinz,7,374,55,86,9,141,0,0,0,0,0,0,2,143,62,132,6,194
Chris St. Croix,7,257,6,31,2,37,0,0,0,0,0,0,2,110,11,40,5,51
Richard Seeley,7,409,22,69,23,91,0,0,0,0,0,0,2,126,18,69,11,87
Ryan Gaucher,7,124,10,25,0,35,0,0,0,0,0,0,2,129,29,58,4,87
Austin Fyten,3,122,9,24,4,33,0,0,0,0,0,0,4,193,55,67,15,122
Austin Madaisky,3,97,16,27,0,43,0,0,0,0,0,0,4,238,29,84,6,113
Ben Thomson,2,114,15,23,14,38,0,0,0,0,0,0,6,352,136,181,2,317
Brad Cole,3,161,5,21,7,26,0,0,0,0,0,0,4,232,21,42,23,63
Brad Voth,3,40,2,3,13,5,0,0,0,0,0,0,4,213,30,27,66,57
Brent Raedeke,4,171,22,21,3,43,0,0,0,0,0,0,3,214,57,85,3,142
Byron Froese,4,143,22,37,1,59,0,0,0,0,0,0,3,212,91,108,1,199
Chris Neiszner,3,18,3,3,0,6,0,0,0,0,0,0,4,286,49,52,8,101
Chris Thompson,6,77,2,12,6,14,0,0,0,0,0,0,2,73,16,32,34,48
Cody Beach,3,98,9,18,33,27,0,0,0,0,0,0,4,169,29,90,55,119
Colin Jacobs,3,44,2,5,2,7,0,0,0,0,0,0,4,186,44,45,5,89
Colin Long,3,53,5,7,0,12,0,0,0,0,0,0,4,228,76,146,1,222
Corbin Baldwin,3,84,0,2,18,2,0,0,0,0,0,0,4,248,11,55,31,66
Craig Brunel,4,94,6,4,35,10,0,0,0,0,0,0,3,160,19,24,69,43
Dallas Jackson,4,127,4,35,0,39,0,0,0,0,0,0,3,174,32,70,2,102
Daniel Tetrault,4,69,0,7,2,7,0,0,0,0,0,0,3,104,16,49,11,65
Dustin Friesen,3,47,3,5,0,8,0,0,0,0,0,0,4,258,26,55,4,81
Garrett Prosofsky,3,7,2,0,0,2,0,0,0,0,0,0,4,258,114,151,8,265
Jace Coyle,3,61,1,7,0,8,0,0,0,0,0,0,4,241,25,82,6,107
Jarrett Smith,4,122,18,24,4,42,0,0,0,0,0,0,3,163,59,91,8,150
Joey Leach,3,17,0,1,1,1,0,0,0,0,0,0,4,210,21,79,9,100
Josh Aspenlind,3,113,4,10,7,14,0,0,0,0,0,0,4,257,62,70,27,132
Karel Mosovsky,4,176,16,10,4,26,0,0,0,0,0,0,3,185,75,85,4,160
Marc Brown,6,361,92,96,3,188,0,0,0,0,0,0,2,136,51,68,7,119
Mark Derlago,4,38,7,9,0,16,0,0,0,0,0,0,3,209,82,80,4,162
Matt Smith,6,59,4,8,3,12,0,0,0,0,0,0,2,7,0,1,0,1
Mike Egener,3,130,3,6,13,9,0,0,0,0,0,0,4,224,6,31,55,37
Myles Stoesz,3,57,1,2,31,3,0,0,0,0,0,0,4,235,9,15,86,24
Nathan Forster,4,82,3,7,3,10,0,0,0,0,0,0,3,184,15,57,22,72
Regan Darby,4,83,0,2,15,2,0,0,0,0,0,0,3,158,8,28,39,36
Ryan Button,3,58,3,1,5,4,0,0,0,0,0,0,4,264,16,97,6,113
Ryley Grantham,4,120,1,12,39,13,0,0,0,0,0,0,3,165,23,26,36,49
Steve Marr,3,79,1,4,1,5,0,0,0,0,0,0,4,242,16,28,6,44
Teigan Zahn,2,13,0,2,0,2,0,0,0,0,0,0,6,287,12,53,39,65
Tim Konsorada,2,28,4,3,0,7,0,0,0,0,0,0,6,311,81,168,8,249
Tim Smith,3,7,0,0,0,0,0,0,0,0,0,0,4,263,90,196,4,286
Turner Elson,4,99,19,14,7,33,0,0,0,0,0,0,3,189,46,48,29,94
Tyler Redenbach,3,155,35,59,0,94,0,0,0,0,0,0,4,261,70,187,4,257
Tyson Marsh,4,53,3,8,9,11,0,0,0,0,0,0,3,204,8,47,25,55
Adam Taylor,2,56,1,1,0,2,0,0,0,0,0,0,5,324,65,118,10,183
Bretton Cameron,2,23,1,5,3,6,0,0,0,0,0,0,5,179,62,58,22,120
Bretton Stamler,2,46,2,6,6,8,0,0,0,0,0,0,5,332,21,74,29,95
Chris Heid,2,66,3,13,0,16,0,0,0,0,0,0,5,225,19,86,5,105
Chris St. Jacques,2,36,1,4,0,5,0,0,0,0,0,0,5,310,152,216,1,368
Daine Todd,2,56,3,29,0,32,0,0,0,0,0,0,5,234,54,99,1,153
Dane Crowley,2,13,2,3,0,5,0,0,0,0,0,0,5,279,21,73,26,94
Derek Hulak,2,73,22,24,0,46,0,0,0,0,0,0,5,267,95,147,1,242
Dustin Johner,2,23,1,1,0,2,0,0,0,0,0,0,5,291,120,152,6,272
Dylan Gyori,5,169,26,27,5,53,0,0,0,0,0,0,2,141,86,119,8,205
Evan Bloodoff,2,57,6,2,0,8,0,0,0,0,0,0,5,279,56,47,11,103
Greg Watson,2,97,10,13,4,23,0,0,0,0,0,0,5,260,71,92,10,163
Jarret Lukin,2,7,0,3,0,3,0,0,0,0,0,0,5,312,86,126,2,212
Joe Barnes,2,16,2,1,1,3,0,0,0,0,0,0,5,240,69,83,10,152
Joel Stepp,2,82,9,8,1,17,0,0,0,0,0,0,5,231,66,63,4,129
Justin Kelly,2,39,4,5,0,9,0,0,0,0,0,0,5,271,71,115,6,186
Justin Maylan,2,5,0,0,0,0,0,0,0,0,0,0,5,331,87,168,7,255
Matt Tassone,2,16,2,0,3,2,0,0,0,0,0,0,5,187,73,46,20,119
Mike Berube,2,9,0,0,2,0,0,0,0,0,0,0,5,317,15,63,25,78
Moises Gutierrez,2,8,1,1,0,2,0,0,0,0,0,0,5,326,68,73,28,141
Paul Brown,2,66,5,5,13,10,0,0,0,0,0,0,5,229,48,79,81,127
Robin Big Snake,2,2,0,0,0,0,0,0,0,0,0,0,5,167,19,30,57,49
Ryan Howse,2,59,6,4,0,10,0,0,0,0,0,0,5,262,140,77,3,217
T.J. Fast,5,120,3,9,0,12,0,0,0,0,0,0,2,97,20,56,0,76
Taylor Peters,2,109,7,12,5,19,0,0,0,0,0,0,5,251,30,44,10,74
Tomas Kudelka,5,182,12,36,7,48,0,0,0,0,0,0,2,123,20,52,1,72
Torrey DiRoberto,5,151,29,31,4,60,0,0,0,0,0,0,2,109,39,63,4,102
Adam Huxley,3,31,0,1,14,1,0,0,0,0,0,0,3,197,9,20,86,29
Aki Seitsonen,3,65,5,5,0,10,0,0,0,0,0,0,3,204,60,67,0,127
Ben Knopp,3,87,9,7,2,16,0,0,0,0,0,0,3,208,96,103,8,199
Brent McDonald,3,106,14,16,0,30,0,0,0,0,0,0,3,209,77,91,6,168
Chad Starling,3,70,0,2,0,2,0,0,0,0,0,0,3,117,8,20,9,28
Colton Jobke,3,13,0,0,0,0,0,0,0,0,0,0,3,191,11,36,18,47
Harrison Ruopp,3,28,0,0,5,0,0,0,0,0,0,0,3,149,2,16,21,18
Jay Langager,3,23,0,0,0,0,0,0,0,0,0,0,3,201,28,88,4,116
Jyri Niemi,3,65,4,8,1,12,0,0,0,0,0,0,3,159,29,66,5,95
Konstantin Panov,3,149,23,45,0,68,0,0,0,0,0,0,3,195,120,116,2,236
Luke Walker,3,183,31,39,6,70,0,0,0,0,0,0,3,202,65,65,13,130
Marek Viedensky,3,120,15,25,1,40,0,0,0,0,0,0,3,183,72,115,6,187
Sean O'Connor,3,44,1,0,7,1,0,0,0,0,0,0,3,184,54,42,44,96
Stefan Schneider,3,127,8,12,1,20,0,0,0,0,0,0,3,175,23,20,6,43
Brenden Kichton,2,141,18,59,1,77,0,0,0,0,0,0,4,260,45,138,3,183
Cameron Abney,2,18,0,0,4,0,0,0,0,0,0,0,4,180,14,23,30,37
Chris Ovington,2,39,0,4,3,4,0,0,0,0,0,0,4,267,11,67,23,78
Dan Gendur,2,20,1,1,0,2,0,0,0,0,0,0,4,200,55,89,3,144
David Bararuk,2,54,5,7,0,12,0,0,0,0,0,0,4,212,68,104,2,172
Gaelan Patterson,2,117,8,19,1,27,0,0,0,0,0,0,4,246,55,75,5,130
Garet Hunt,2,10,0,1,3,1,0,0,0,0,0,0,4,193,16,25,56,41
Gerard DiCaire,2,93,3,14,0,17,0,0,0,0,0,0,4,275,47,151,2,198
Harlan Pratt,4,218,11,37,1,48,0,0,0,0,0,0,2,71,9,23,3,32
Igor Valeev,4,204,16,33,30,49,0,0,0,0,0,0,2,67,11,10,11,21
"Jon ""Nasty"" Mirasty",4,182,1,6,79,7,0,0,0,0,0,0,2,78,1,2,38,3
Jordan Bendfeld,2,26,0,1,6,1,0,0,0,0,0,0,4,225,17,50,34,67
Josh Caron,2,24,0,0,3,0,0,0,0,0,0,0,4,171,3,19,42,22
Josh Nicholls,2,11,0,1,0,1,0,0,0,0,0,0,4,261,91,137,5,228
Kale Kessy,2,71,5,7,14,12,0,0,0,0,0,0,4,193,25,44,38,69
Keith Seabrook,4,201,19,50,1,69,0,0,0,0,0,0,2,123,19,53,2,72
Ladislav Kouba,2,6,0,0,0,0,0,0,0,0,0,0,4,217,35,59,1,94
Lane Scheidl,2,34,3,5,1,8,0,0,0,0,0,0,4,205,47,59,6,106
Mark Santorelli,4,186,20,32,0,52,0,0,0,0,0,0,2,144,56,127,0,183
Martin Podlesak,4,76,7,15,1,22,0,0,0,0,0,0,2,94,35,39,1,74
Matt Lowry,2,31,0,2,6,2,0,0,0,0,0,0,4,209,47,113,16,160
Reece Scarlett,2,105,8,37,1,45,0,0,0,0,0,0,4,209,16,67,4,83
Rick Kozak,2,5,0,1,0,1,0,0,0,0,0,0,4,152,37,28,24,65
Riley Boychuk,2,44,1,3,3,4,0,0,0,0,0,0,4,194,39,44,20,83
Steve Crampton,2,11,2,2,1,4,0,0,0,0,0,0,4,230,74,82,33,156
Travis Ewanyk,2,137,10,10,19,20,0,0,0,0,0,0,4,127,18,18,15,36
Troy Rutkowski,2,27,3,2,0,5,0,0,0,0,0,0,4,279,41,109,8,150
Tysen Dowzak,2,3,0,0,0,0,0,0,0,0,0,0,4,219,4,34,14,38
Darren Van Oene,7,497,80,106,65,186,0,0,0,0,0,0,1,51,23,24,14,47
Adam Hughesman,1,3,1,0,0,1,0,0,0,0,0,0,6,337,140,210,5,350
Brady Brassart,2,81,9,13,1,22,0,0,0,0,0,0,3,188,42,64,6,106
Cam McCaffrey,2,10,2,4,2,6,0,0,0,0,0,0,3,201,27,16,64,43
Casey Pierro-Zabotel,3,17,1,2,0,3,0,0,0,0,0,0,2,121,55,108,2,163
Collin Bowman,1,21,2,6,1,8,0,0,0,0,0,0,6,345,35,114,17,149
Dan Vandermeer,3,3,0,0,0,0,0,0,0,0,0,0,2,125,23,52,8,75
Darren Dietz,2,105,4,18,10,22,0,0,0,0,0,0,3,148,24,49,12,73
Darren Kramer,3,136,8,14,57,22,0,0,0,0,0,0,2,139,29,25,72,54
Darren Lynch,1,3,0,2,0,2,0,0,0,0,0,0,6,291,88,130,1,218
Denny Johnston,1,10,1,1,5,2,0,0,0,0,0,0,6,300,51,94,18,145
Gerad Adams,3,15,0,0,0,0,0,0,0,0,0,0,2,126,32,62,22,94
Igor Pohanka,2,109,16,30,0,46,0,0,0,0,0,0,3,184,66,107,0,173
J.C. Lipon,2,147,14,53,29,67,0,0,0,0,0,0,3,187,25,74,28,99
Joey Hope,2,86,1,6,0,7,0,0,0,0,0,0,3,187,28,81,21,109
Josh Winquist,2,47,8,11,1,19,0,0,0,0,0,0,3,183,30,42,2,72
Judd Blackwater,2,38,4,1,2,5,0,0,0,0,0,0,3,171,50,64,20,114
Justin Bernhardt,1,14,1,2,0,3,0,0,0,0,0,0,6,307,103,139,22,242
Keegan Dansereau,1,26,4,3,0,7,0,0,0,0,0,0,6,311,108,133,5,241
Kevin Saurette,2,27,2,2,0,4,0,0,0,0,0,0,3,153,15,30,3,45
Kyle Kos,3,27,1,2,1,3,0,0,0,0,0,0,2,136,16,64,4,80
Matt McCue,1,10,1,0,4,1,0,0,0,0,0,0,6,247,15,48,46,63
Mike Varhaug,3,13,0,1,5,1,0,0,0,0,0,0,2,66,1,2,31,3
Mitch Fadden,1,53,7,12,0,19,0,0,0,0,0,0,6,339,136,182,6,318
Nathan Deck,1,33,1,7,0,8,0,0,0,0,0,0,6,276,22,96,2,118
Ondrej Roman,2,112,10,20,0,30,0,0,0,0,0,0,3,172,29,111,1,140
Reid Petryk,2,37,4,9,1,13,0,0,0,0,0,0,3,188,32,32,10,64
Riley Emmerson,3,46,0,0,20,0,0,0,0,0,0,0,2,101,1,1,24,2
Robin Figren,3,141,17,21,1,38,0,0,0,0,0,0,2,97,28,30,0,58
Rory Rawlyk,3,33,2,6,0,8,0,0,0,0,0,0,2,120,16,31,1,47
Taylor Aronson,3,99,3,32,1,35,0,0,0,0,0,0,2,142,10,57,2,67
Trevor Johnson,1,3,0,0,1,0,0,0,0,0,0,0,6,394,62,177,29,239
Troy Bourke,2,76,12,17,0,29,0,0,0,0,0,0,3,144,40,61,3,101
William Wrenn,3,93,5,12,10,17,0,0,0,0,0,0,2,89,5,24,2,29
Art Bidlevskii,1,10,0,1,4,1,0,0,0,0,0,0,5,316,5,41,56,46
Bobby Russell,5,153,14,15,0,29,0,0,0,0,0,0,1,72,32,43,1,75
Brad Zanon,1,4,0,0,0,0,0,0,0,0,0,0,5,328,23,72,23,95
Brady Leavold,1,4,0,0,0,0,0,0,0,0,0,0,5,200,47,73,30,120
Cameron Cepek,1,3,0,0,0,0,0,0,0,0,0,0,5,263,20,73,35,93
Chris Cloud,1,10,0,0,3,0,0,0,0,0,0,0,5,294,38,52,61,90
Chris Durand,1,3,0,0,0,0,0,0,0,0,0,0,5,330,78,125,8,203
Colton Yellowhorn,1,28,6,12,0,18,0,0,0,0,0,0,5,330,153,196,5,349
Darren McLachlan,1,11,1,0,5,1,0,0,0,0,0,0,5,215,47,70,79,117
Greg Black,1,39,4,5,12,9,0,0,0,0,0,0,5,258,80,63,53,143
Greg Gardner,1,5,0,0,0,0,0,0,0,0,0,0,5,338,54,65,7,119
James Hiebert,1,6,0,0,2,0,0,0,0,0,0,0,5,242,70,104,30,174
Jason Bast,1,2,0,0,0,0,0,0,0,0,0,0,5,331,114,140,1,254
Justin Weller,1,3,0,0,0,0,0,0,0,0,0,0,5,259,9,32,22,41
Kevin King,1,5,0,0,0,0,0,0,0,0,0,0,5,335,95,131,14,226
Kyle Bailey,1,5,0,0,0,0,0,0,0,0,0,0,5,263,55,105,33,160
Luke Fritshaw,1,1,0,0,0,0,0,0,0,0,0,0,5,270,14,75,25,89
Mark Isherwood,1,2,0,0,0,0,0,0,0,0,0,0,5,268,44,84,23,128
Ryan Cuthbert,1,11,0,3,2,3,0,0,0,0,0,0,5,319,59,105,32,164
Shaun Landolt,1,4,0,0,0,0,0,0,0,0,0,0,5,284,60,81,15,141
Shayne Neigum,1,8,0,0,3,0,0,0,0,0,0,0,5,267,35,34,47,69
A.J. Thelen,2,10,0,0,0,0,0,0,0,0,0,0,2,125,21,36,3,57
Adam Courchaine,1,10,0,0,0,0,0,0,0,0,0,0,4,285,131,152,0,283
Adam Smith,2,93,8,9,8,17,0,0,0,0,0,0,2,20,0,0,6,0
Alex Leavitt,2,43,13,21,0,34,0,0,0,0,0,0,2,135,43,87,3,130
Andrew Clark,1,35,7,12,0,19,0,0,0,0,0,0,4,254,93,123,5,216
Andrew Luciuk,4,6,2,0,0,2,0,0,0,0,0,0,1,63,30,46,3,76
Ben Johnson,2,33,1,2,0,3,0,0,0,0,0,0,2,31,2,5,1,7
Ben Wilson,2,38,0,3,8,3,0,0,0,0,0,0,2,138,8,29,26,37
Branden Troock,2,50,6,9,1,15,0,0,0,0,0,0,2,67,16,16,2,32
Brett Lyon,1,5,0,0,5,0,0,0,0,0,0,0,4,224,21,41,56,62
Chandler Stephenson,2,56,8,7,0,15,0,0,0,0,0,0,2,115,29,32,0,61
Chris Barr,1,9,0,2,1,2,0,0,0,0,0,0,4,239,12,30,21,42
Chris Francis,1,4,1,1,0,2,0,0,0,0,0,0,4,279,66,123,0,189
Cody Sylvester,1,17,2,0,0,2,0,0,0,0,0,0,4,247,56,83,11,139
Cory Morgan,2,7,0,3,0,3,0,0,0,0,0,0,2,135,57,58,13,115
Dan Baum,1,37,4,6,12,10,0,0,0,0,0,0,4,258,79,100,65,179
David Rutherford,1,18,1,6,0,7,0,0,0,0,0,0,4,163,57,54,10,111
David Svagrovsky,2,30,0,2,1,2,0,0,0,0,0,0,2,120,23,36,2,59
Derek LeBlanc,1,11,0,1,0,1,0,0,0,0,0,0,4,244,49,52,23,101
Frank Mrazek,2,67,4,13,0,17,0,0,0,0,0,0,2,125,64,66,5,130
Gennady Razin,4,258,7,38,2,45,0,0,0,0,0,0,1,70,2,11,0,13
Giffen Nyren,1,15,1,3,0,4,0,0,0,0,0,0,4,269,28,97,9,125
Graham Black,2,48,7,7,0,14,0,0,0,0,0,0,2,77,18,34,1,52
Greg Phillips,4,168,44,29,13,73,0,0,0,0,0,0,1,69,34,49,9,83
Harlan Anderson,1,9,0,0,0,0,0,0,0,0,0,0,4,258,32,107,5,139
Jake Riddle,1,6,0,0,0,0,0,0,0,0,0,0,4,274,79,87,25,166
James DeMone,1,55,1,8,5,9,0,0,0,0,0,0,4,232,7,36,37,43
James McEwan,1,4,0,0,2,0,0,0,0,0,0,0,4,208,7,10,73,17
Joel Edmundson,2,94,8,12,6,20,0,0,0,0,0,0,2,127,6,37,14,43
Juraj Simek,4,236,40,44,2,84,0,0,0,0,0,0,1,58,28,29,1,57
Justin Feser,1,6,0,2,0,2,0,0,0,0,0,0,4,278,111,136,4,247
Juuso Puustinen,2,128,31,32,0,63,0,0,0,0,0,0,2,124,59,65,2,124
Kenton Miller,1,6,0,0,0,0,0,0,0,0,0,0,4,240,60,57,10,117
Kurt Drummond,2,86,3,7,0,10,0,0,0,0,0,0,2,123,18,76,3,94
Lucas Bloodoff,1,0,0,0,0,0,0,0,0,0,0,0,4,259,64,60,19,124
Luke Curtin,4,18,1,6,0,7,0,0,0,0,0,0,1,51,29,48,0,77
Marcel Noebels,2,95,16,18,1,34,0,0,0,0,0,0,2,128,48,64,1,112
Marek Tvrdon,2,52,10,19,0,29,0,0,0,0,0,0,2,72,37,48,1,85
Martin Sagat,2,131,17,19,1,36,0,0,0,0,0,0,2,129,28,78,2,106
Marty Standish,2,15,2,6,2,8,0,0,0,0,0,0,2,141,55,67,9,122
Matej Stransky,2,135,16,26,2,42,0,0,0,0,0,0,2,141,53,54,2,107
Michael St. Croix,1,13,0,0,0,0,0,0,0,0,0,0,4,208,91,137,1,228
Mike Bayrack,2,4,0,1,0,1,0,0,0,0,0,0,2,136,58,71,12,129
Myles Bell,1,2,0,0,0,0,0,0,0,0,0,0,4,189,33,72,7,105
Oliver Gabriel,1,11,1,0,0,1,0,0,0,0,0,0,4,171,47,62,12,109
Randy McNaught,1,1,0,0,0,0,0,0,0,0,0,0,4,154,15,12,34,27
Reagan Rome,2,40,1,10,1,11,0,0,0,0,0,0,2,48,0,1,3,1
Richard Nedomlel,2,3,0,0,0,0,0,0,0,0,0,0,2,138,10,46,10,56
Rob Voltera,4,136,3,9,49,12,0,0,0,0,0,0,1,20,2,3,2,5
Robin Soudek,1,3,1,0,0,1,0,0,0,0,0,0,4,250,70,81,17,151
Ryan Pulock,2,57,17,13,0,30,0,0,0,0,0,0,2,134,27,75,0,102
Shane McColgan,1,5,0,0,0,0,0,0,0,0,0,0,4,212,65,137,8,202
Shawn Legault,4,15,0,0,17,0,0,0,0,0,0,0,1,2,0,0,0,0
Shawn Limpright,1,45,9,9,5,18,0,0,0,0,0,0,4,264,93,127,21,220
Shea Theodore,2,13,4,7,0,11,0,0,0,0,0,0,2,73,4,31,0,35
Spencer Asuchak,1,18,2,4,3,6,0,0,0,0,0,0,4,224,49,46,10,95
Spencer Bennett,2,11,2,1,0,3,0,0,0,0,0,0,2,143,56,54,3,110
Tomas Slovak,2,101,3,16,3,19,0,0,0,0,0,0,2,118,20,77,1,97
Trevor Cheek,2,112,9,14,4,23,0,0,0,0,0,0,2,124,33,41,4,74
Tristan King,1,11,2,2,0,4,0,0,0,0,0,0,4,250,50,91,7,141
Zach Yuen,1,3,0,0,1,0,0,0,0,0,0,0,4,184,21,53,2,74
Antoine Corbin,1,30,1,2,0,3,0,0,0,0,0,0,3,187,25,43,7,68
Boris Protsenko,3,131,39,45,3,84,0,0,0,0,0,0,1,70,40,47,5,87
Brock Montgomery,1,6,0,0,1,0,0,0,0,0,0,0,3,185,34,37,21,71
Cam Reid,3,70,6,18,1,24,0,0,0,0,0,0,1,31,13,19,0,32
Corey Fienhage,3,27,0,4,0,4,0,0,0,0,0,0,1,70,4,10,4,14
Curtis Valk,1,1,0,0,0,0,0,0,0,0,0,0,3,127,32,40,2,72
David Kaczowka,1,1,0,0,0,0,0,0,0,0,0,0,3,186,10,11,110,21
Derek Schutz,1,20,1,2,0,3,0,0,0,0,0,0,3,188,59,90,24,149
Dyson Stevenson,1,6,0,0,1,0,0,0,0,0,0,0,3,124,21,28,25,49
Graeme Craig,1,1,0,0,0,0,0,0,0,0,0,0,3,189,5,19,12,24
Jake Doty,1,14,2,4,2,6,0,0,0,0,0,0,3,130,6,8,40,14
Jan Fadrny,1,60,8,14,1,22,0,0,0,0,0,0,3,158,63,88,2,151
Jared Smyth,1,2,0,0,0,0,0,0,0,0,0,0,3,197,30,47,19,77
Kendall McFaull,1,2,0,1,0,1,0,0,0,0,0,0,3,198,11,24,8,35
Kenton Smith,1,9,0,1,0,1,0,0,0,0,0,0,3,209,33,107,7,140
Les Borsheim,1,16,0,1,3,1,0,0,0,0,0,0,3,102,7,24,15,31
Lukas Sutter,1,17,0,1,1,1,0,0,0,0,0,0,3,148,32,47,28,79
Mike Aviani,1,2,0,0,0,0,0,0,0,0,0,0,3,133,21,37,10,58
Mitch Holmberg,1,1,0,1,0,1,0,0,0,0,0,0,3,176,46,52,0,98
Mitch Versteeg,1,3,0,0,0,0,0,0,0,0,0,0,3,148,12,29,23,41
Mitchell Moroz,1,66,5,4,13,9,0,0,0,0,0,0,3,74,16,10,19,26
Robin Gomez,1,3,0,0,3,0,0,0,0,0,0,0,3,187,22,40,81,62
Ryan Constant,3,26,1,2,1,3,0,0,0,0,0,0,1,2,0,0,0,0
Ryan Olsen,1,60,4,5,2,9,0,0,0,0,0,0,3,135,22,24,3,46
Stefan Cherneski,3,40,2,9,4,11,0,0,0,0,0,0,1,65,43,38,13,81
Steven Hodges,1,23,1,1,0,2,0,0,0,0,0,0,3,135,26,33,2,59
Steven Later,1,11,0,1,0,1,0,0,0,0,0,0,3,139,18,58,30,76
Trevor Baker,3,41,2,4,2,6,0,0,0,0,0,0,1,19,4,2,7,6
Andrei Lupandin,1,5,1,0,0,1,0,0,0,0,0,0,2,135,43,78,20,121
Brad Mehalko,2,68,10,18,8,28,0,0,0,0,0,0,1,55,26,49,5,75
Brady Austin,1,66,1,9,1,10,0,0,0,0,0,0,2,112,1,6,42,7
Brendan Leipsic,1,74,14,40,0,54,0,0,0,0,0,0,2,133,44,47,7,91
Clint Cabana,2,34,0,4,8,4,0,0,0,0,0,0,1,51,2,6,16,8
Cody Blanshan,1,6,0,0,1,0,0,0,0,0,0,0,2,139,10,28,16,38
Collin Valcourt,1,1,0,0,0,0,0,0,0,0,0,0,2,122,24,31,16,55
David Turon,2,35,2,4,0,6,0,0,0,0,0,0,1,36,3,6,0,9
Fredrik Pettersson,1,67,11,21,0,32,0,0,0,0,0,0,2,111,43,50,1,93
Glenn Olson,2,55,1,2,20,3,0,0,0,0,0,0,1,41,2,1,12,3
Greg Chase,1,5,1,0,0,1,0,0,0,0,0,0,2,65,6,22,1,28
Gustav Engman,1,5,0,1,0,1,0,0,0,0,0,0,2,126,10,17,6,27
Hunter Shinkaruk,1,74,16,15,0,31,0,0,0,0,0,0,2,129,63,70,0,133
Jack Rodewald,1,9,0,1,0,1,0,0,0,0,0,0,2,70,6,6,3,12
Jay Banach,2,2,0,0,0,0,0,0,0,0,0,0,1,3,0,0,0,0
Jeff Lee,1,2,0,0,0,0,0,0,0,0,0,0,2,119,29,52,6,81
Josh Birkholz,1,4,0,0,0,0,0,0,0,0,0,0,2,138,47,39,3,86
Justin Hickman,1,5,1,0,0,1,0,0,0,0,0,0,2,117,12,12,11,24
Kevin Marsh,1,2,0,0,0,0,0,0,0,0,0,0,2,105,47,54,0,101
Kirill Starkov,2,29,5,6,0,11,0,0,0,0,0,0,1,72,34,37,1,71
Kristians Pelss,1,20,1,7,0,8,0,0,0,0,0,0,2,126,42,41,5,83
Kyle Burroughs,1,9,0,0,0,0,0,0,0,0,0,0,2,56,2,6,6,8
Luc Theoret,1,25,1,4,1,5,0,0,0,0,0,0,2,114,25,76,5,101
Martin Gernat,2,111,5,25,0,30,0,0,0,0,0,0,1,60,9,46,0,55
Mason Geertsen,1,9,0,0,0,0,0,0,0,0,0,0,2,37,0,3,8,3
Matthew Pufahl,1,5,1,0,0,1,0,0,0,0,0,0,2,75,2,13,2,15
Michael Young,1,1,0,0,0,0,0,0,0,0,0,0,2,17,0,2,0,2
Mike Ullrich,1,12,1,2,0,3,0,0,0,0,0,0,2,36,2,4,1,6
Nick Walters,1,4,0,0,0,0,0,0,0,0,0,0,2,110,6,16,12,22
Quinn Hancock,2,70,10,21,0,31,0,0,0,0,0,0,1,69,54,58,1,112
Ryan Wade,1,1,0,0,0,0,0,0,0,0,0,0,2,115,52,65,4,117
Shane Belter,2,56,4,9,3,13,0,0,0,0,0,0,1,65,22,39,1,61
Shawn McNeil,1,1,0,0,0,0,0,0,0,0,0,0,2,144,91,121,2,212
Stefan Warg,1,21,0,1,0,1,0,0,0,0,0,0,2,134,1,36,3,37
Todd Robinson,1,15,2,7,0,9,0,0,0,0,0,0,2,107,57,109,0,166
Trevor Wasyluk,1,47,6,7,0,13,0,0,0,0,0,0,2,99,32,46,11,78
Zdenek Bahensky,1,13,0,1,0,1,0,0,0,0,0,0,2,131,33,53,4,86
Adam Ross,1,4,0,0,0,0,0,0,0,0,0,0,1,5,2,0,0,2
Ben Walker,1,36,1,3,0,4,0,0,0,0,0,0,1,46,8,26,2,34
Brayden Point,1,9,2,2,0,4,0,0,0,0,0,0,1,5,1,0,0,1
Brett Lernout,1,6,0,0,0,0,0,0,0,0,0,0,1,2,0,0,0,0
Brycen Martin,1,2,0,0,0,0,0,0,0,0,0,0,1,3,0,0,0,0
Calder Brooks,1,3,0,0,0,0,0,0,0,0,0,0,1,53,5,19,2,24
Chad Wilchynski,1,6,0,0,0,0,0,0,0,0,0,0,1,39,9,24,1,33
Cody Corbett,1,47,3,3,0,6,0,0,0,0,0,0,1,54,6,20,0,26
Colby Cave,1,1,0,0,0,0,0,0,0,0,0,0,1,70,6,10,3,16
Cole Ully,1,2,0,1,0,1,0,0,0,0,0,0,1,55,9,11,0,20
Cory Cyrenne,1,7,0,2,0,2,0,0,0,0,0,0,1,72,47,71,0,118
David Toews,1,2,0,0,0,0,0,0,0,0,0,0,1,60,20,28,0,48
Dillon Heatherington,1,3,0,1,0,1,0,0,0,0,0,0,1,57,2,8,3,10
Haydn Fleury,1,1,1,0,0,1,0,0,0,0,0,0,1,4,0,0,0,0
Jackson Houck,1,7,0,1,0,1,0,0,0,0,0,0,1,53,8,12,5,20
Jason Norrie,1,7,0,0,3,0,0,0,0,0,0,0,1,63,18,25,25,43
Jayden Hart,1,11,4,0,1,4,0,0,0,0,0,0,1,67,13,19,3,32
Jesse Mychan,1,3,0,0,0,0,0,0,0,0,0,0,1,44,10,9,15,19
John McNabb,1,1,0,0,0,0,0,0,0,0,0,0,1,5,0,0,0,0
John Morlang,1,25,2,2,1,4,0,0,0,0,0,0,1,4,1,1,0,2
Josh Morrissey,1,8,0,1,0,1,0,0,0,0,0,0,1,68,10,28,2,38
Justin Coutu,1,4,0,0,0,0,0,0,0,0,0,0,1,5,0,2,0,2
Keegan Kanzig,1,0,0,0,0,0,0,0,0,0,0,0,1,63,0,2,6,2
Kent Sauer,1,4,0,0,0,0,0,0,0,0,0,0,1,65,12,13,6,25
Kevin McDonald,1,8,0,0,2,0,0,0,0,0,0,0,1,70,26,16,20,42
Marc McNulty,1,0,0,0,0,0,0,0,0,0,0,0,1,21,0,0,0,0
Marek Ivan,1,7,0,2,0,2,0,0,0,0,0,0,1,70,24,19,9,43
Morgan Klimchuk,1,4,0,0,0,0,0,0,0,0,0,0,1,67,18,18,0,36
Pat Stachniak,1,2,0,0,0,0,0,0,0,0,0,0,1,15,0,0,1,0
Scott Burt,1,1,0,0,0,0,0,0,0,0,0,0,1,68,41,36,5,77
Tanner Eberle,1,6,0,0,0,0,0,0,0,0,0,0,1,66,10,18,5,28
Taylor Leier,1,73,13,18,1,31,0,0,0,0,0,0,1,72,13,24,2,37
Taylor Stefishen,1,4,0,1,0,1,0,0,0,0,0,0,1,68,24,43,4,67
Tim Bozon,1,1,0,0,0,0,0,0,0,0,0,0,1,71,36,35,2,71
Tommi Kivisto,1,17,0,2,0,2,0,0,0,0,0,0,1,65,1,21,3,22
Toni Rajala,1,46,17,28,0,45,0,0,0,0,0,0,1,60,26,37,0,63
Tony Mohagen,1,1,0,0,1,0,0,0,0,0,0,0,1,62,7,11,31,18
